Address,Volume,Number_of_Transactions,Number_of_Received_Transactions,Number_of_Sent_Transactions,Amount Received,Amount_Sent,Mean_of_Received,Mean_of_Sent,Stddev_of_Received,Stddev_of_Sent,Maximum_Amount_of_Sent_&_Received,Last_Balance
0x6546055f46e866a4B9a4A13e81273e3152BAE5dA,4026820191,3728,1797,1931,1997151158,2029669033,1111380.7223149694,1051097.3759709995,1511333.6231899713,1677162.5365123276,18901338,12834642
0x9008D19f58AAbD9eD0D60971565AA8510560ab41,179155907,105,54,51,89480461,89675446,1657045.5740740742,1758342.0784313725,1526022.1068359348,1792572.2017349417,10000000,54165
0xBb98E9Df4Ce996762785b867f0b09746F4eFe79B,52224078,8,8,0,52224078,0,6528009.75,0,6366692.287756507,0,16652044,52224078
0x5bdf85216ec1e38D6458C870992A69e38e03F7Ef,420972126,107,39,68,217404918,203567208,5574485.076923077,2993635.411764706,6709687.577007345,7578965.943051924,50000000,63336411
0x35E2a11f743A43F00381A0aEb6764322eF1Eb788,99829444,8,4,4,49914722,49914722,12478680.5,12478680.5,4198101.042828322,4198101.042828322,16698840,0
0x6cC5F688a315f3dC28A7781717a9A798a59fDA7b,6753444012,705,268,437,3284451969,3468992043,12255417.79477612,7938196.894736842,50297977.081701376,27713298.938275564,500001000,692615340
0xE37e799D5077682FA0a244D46E5649F71457BD09,535833760,302,131,171,267916880,267916880,2045167.0229007634,1566765.380116959,2173973.4389592055,2281934.5932563194,16698840,1
0x77134cbC06cB00b66F4c7e623D5fdBF6777635EC,30278843324,300,122,178,15902030227,14376813097,130344510.05737706,80768612.90449437,404763845.77509415,279464082.08047664,3006571630,1982034414
0x92814cb59107a1418c9596e09551FDBe7BC45551,959933872,24,12,12,479966936,479966936,39997244.666666664,39997244.666666664,21313771.021006167,21313771.021006167,80000000,0
0xf23FdA58C7B927AbaE31a3c83809424F748C5B88,271298,1,0,1,0,271298,0,271298.0,0,0.0,271298,0
0xad3b67BCA8935Cb510C8D18bD45F0b94F54A968f,31458699,33,15,18,15721683,15737016,1048112.2,874278.6666666666,889346.9002254931,890323.1703526409,2882863,1
0x3aB28eCeDEa6cdb6feeD398E93Ae8c7b316B1182,32409620,1,0,1,0,32409620,0,32409620.0,0,0.0,32409620,0
0x6D0D19bddDC5ED1dD501430c9621DD37ebd9062d,88483390,28,5,23,52720330,35763060,10544066.0,1554915.652173913,11815754.831668707,997518.469890358,32409620,16957270
0x0f3563D5A39f6Add7E60630BD14f9D8dED0CDC5e,16628580,17,9,8,7324457,9304123,813828.5555555555,1163015.375,764084.4459395122,532876.9645187662,2028398,4000000
0x87f763BB415abE13419632605e62697c98EDAfC1,149758,1,1,0,149758,0,149758.0,0,0.0,0,149758,149758
0xC4334A9AF50C80A12C484de643149f6159Bdd110,44702639,78,9,69,16673824,28028815,1852647.111111111,406214.71014492755,1847552.7430017882,809391.1418448805,6569384,7893
0x9B6378Fb1A3b76DBC07a0Be70Cdc4d69a7b0132a,355723,1,1,0,355723,0,355723.0,0,0.0,0,355723,355723
0x5770815B0c2a09A43C9E5AEcb7e2f3886075B605,3957990683,28,11,17,2070990683,1887000000,188271880.27272728,111000000.0,213368114.49321827,155667821.29982835,549999114,715981249
0x8D6826ceb7dF7f03d2CD94eC681638258764fbd2,13326649,37,17,20,5339506,7987143,314088.5882352941,399357.15,212410.9424175525,198634.828577537,944158,82099
0x3fC91A3afd70395Cd496C647d5a6CC9D4B2b7FAD,568157232,1772,604,1168,284078616,284078616,470328.8344370861,243217.99315068492,896398.0448480295,692596.8696239318,5179815,0
0xA88800CD213dA5Ae406ce248380802BD53b47647,38357004,40,20,20,19178502,19178502,958925.1,958925.1,954936.9644645085,954936.9644645085,2809244,0
0x99aE63d99FBF1725E20f3e4fD5595D254879944e,5301198,3,2,1,2650599,2650599,1325299.5,2650599.0,697721.5,0.0,2650599,0
0x6b75d8AF000000e20B7a7DDf000Ba900b4009A80,902034259,466,233,233,451017327,451016932,1935696.6824034334,1935694.9871244635,2090057.0148603108,2090056.5712075823,12911579,472
0xb9F3Ede7F0Db943968DbbcD4Eb522370A325DE49,1038665,1,1,0,1038665,0,1038665.0,0,0.0,0,1038665,1247174
0xC61206FDC09e595b8BE1d2b4a708f27D2bDEA64c,226441,3,0,3,0,226441,0,75480.33333333333,0,71049.2997494619,175957,100256
0x04F07Bd4F24130D694a61140Bc594E7E749afD74,1406966,8,6,2,703483,703483,117247.16666666667,351741.5,186364.22360565583,227541.5,579283,0
0xa7Ca2C8673bcFA5a26d8ceeC2887f2CC2b0Db22A,84542222,100,39,61,42271111,42271111,1083874.641025641,692969.0327868853,1325874.4680576297,1172639.4561766463,6730018,0
0xeb4Af8a64070Ef0dEa6260e0Bf2310748f014d88,330909,23,22,1,193255,137654,8784.318181818182,137654.0,10755.522122427763,0.0,137654,56499
0x414e7DE5C8D0E8B9A33f2477275aC77A71a27284,789266,1,0,1,0,789266,0,789266.0,0,0.0,789266,0
0x2D4bc9c21427160D5Dca3DF6443C3d6e1228782b,403554,3,2,1,201777,201777,100888.5,201777.0,75068.5,0.0,201777,0
0x02c9e5D26f7Fc0121e030BA0039C3e80533F6F8a,285528,5,4,1,142764,142764,35691.0,142764.0,2994.653318833417,0.0,142764,0
0x74de5d4FCbf63E00296fd95d33236B9794016631,344044024,391,195,196,172022012,172022012,882164.1641025641,877663.3265306122,1566262.4921917436,1458374.1118772968,11526702,0
0x235b31D3B1a6AA1abA231B8a14bc2A08668B1fd0,86948,2,1,1,43474,43474,43474.0,43474.0,0.0,0.0,43474,0
0x6b2980979D29C15c6438FfF1cB9c1e4127370969,309323395,90,17,73,125566564,183756831,7386268.470588235,2517216.8630136987,9624937.417595303,10026560.688195838,86142515,0
0xF90A6aFFC58416E5FD9670A6CdeBB79cA2A48E24,25405911,12,7,5,11376300,14029611,1625185.7142857143,2805922.2,1182413.0248033002,3651698.109347398,10000000,0
0x3BeCa9C1C393a9bb432f74De389CD0fd3ADEA83C,54649258,45,15,30,27324958,27324300,1821663.8666666667,910810.0,2337746.96433687,850375.6520307168,10000000,672
0x0F26C0c9B47c4ADC483f7d9c158605faCA03E883,274137955,350,185,165,141556076,132581879,765167.9783783783,803526.5393939394,761169.4072035933,593092.6626777538,8000000,13627865
0x6186E141097f864C01B15A16da54cB7CD9889951,63067416,44,22,22,10299763,52767653,468171.04545454547,2398529.6818181816,205164.65328729982,8697015.126039924,42234360,1
0xaa0d2E09032F7245d5Ba3bbcBa33Ef7bB0593C41,330071,9,9,0,330071,0,36674.555555555555,0,19198.291290350186,0,78400,360444
0x94B562250e4530291108134E84f6e9D5a5c2286b,3357268,12,8,4,1678634,1678634,209829.25,419658.5,214157.79473600184,347879.9888564302,923824,0
0x00000000A991C429eE2Ec6df19d40fe0c80088B8,110869478,40,20,20,55434749,55434729,2771737.45,2771736.45,1990368.450963275,1990368.450963275,7685324,28
0x00FC00900000002C00BE4EF8F49c000211000c43,132091196,54,27,27,66045616,66045580,2446133.925925926,2446132.592592593,3181313.0515359,3181313.226837508,12518024,61
0x43DC43100a97A6eb2d89fAb8D27a15Fb8E2Ea0CF,148009308,147,66,81,73650930,74358378,1115923.1818181819,918004.6666666666,1153148.8576880302,1228996.3782736214,6143418,57
0x75A761c8cc3E5Fc464c02C99c5434eDC2B166bc8,11722,1,1,0,11722,0,11722.0,0,0.0,0,11722,18630
0x132dFAA30fFC51Ab1793F12d6bE22ad725b1533e,107000,2,0,2,0,107000,0,53500.0,0,46500.0,100000,1065
0x284294ab567EB1f399dD78Cc037f00E3bB6F9cb0,407180,15,10,5,203590,203590,20359.0,40718.0,26915.706139724443,34257.123002377186,107000,0
0x75e89d5979E4f6Fba9F97c104c2F0AFB3F1dcB88,473549769,278,123,155,231383864,242165905,1881169.6260162601,1562360.677419355,3796005.720727602,3711461.744636527,33500000,28060451
0xB43Babc211ecE1b60CA64Ffd16DFB1feB2Df2e0b,18652211,4,2,2,12652211,6000000,6326105.5,3000000.0,5176961.5,1200000.0,11503067,6652211
0x5db209f7f4cbd7011B486b8d99e5ae616947a138,3034482,4,2,2,1517241,1517241,758620.5,758620.5,91110.5,91110.5,849731,0
0x8eB2283F696F2a130134d46E28d3528e19e16868,60459350,30,15,15,30229660,30229690,2015310.6666666667,2015312.6666666667,881756.3594967086,881755.6930614184,4457000,4
0xd83eB40979cA0Dabe945E22629A72765dc9A39bD,17805679,8,4,4,8902490,8903189,2225622.5,2225797.25,592730.1430826257,592751.178124251,3057000,50
0x0D0707963952f2fBA59dD06f2b425ace40b492Fe,2130730485,519,131,388,1116436634,1014293851,8522417.053435115,2614159.4097938146,26610256.750807915,12577837.387968272,283970000,423234101
0x2a4090d6529E3cA13Cf93b096107fab5312d556d,20307994,4,2,2,10153997,10153997,5076998.5,5076998.5,2387221.5,2387221.5,7464220,0
0x7825387BE64e2E864b25A9E82Ffe59D61502c82c,2056764,2,1,1,1028382,1028382,1028382.0,1028382.0,0.0,0.0,1028382,0
0xcc88036Fa05c86129Bf66260c2A905AB2c7B663C,52316350,27,14,13,26158160,26158190,1868440.0,2012168.4615384615,545812.513074381,565507.3782535216,3054000,42
0x03b970587942aC8d1b3f4497078B06f45bCF5Ee8,5379554,2,1,1,2689777,2689777,2689777.0,2689777.0,0.0,0.0,2689777,0
0xB52a8587162FfA8fF4D1f53D4Cf47A46A8D016bd,70000,2,1,1,35000,35000,35000.0,35000.0,0.0,0.0,35000,0
0x6E50D3C6B659dB780f21da84fA8194F437239Ca6,321910000,24,12,12,160955000,160955000,13412916.666666666,13412916.666666666,6678349.801888853,6678349.801888853,30000000,0
0xD40e98C741354062bD5f91621F784Ed0fCE045C9,60024,2,1,1,30012,30012,30012.0,30012.0,0.0,0.0,30012,0
0xa51fb65343104b3A7e99f45871B543434C9794da,155970472,8,4,4,77985236,77985236,19496309.0,19496309.0,3643591.0210322044,3643591.0210322044,24999183,0
0x6bfBB851e028B968E2102f023EeF759F83E2cc1A,1397305,10,0,10,0,1397305,0,139730.5,0,303142.505463767,1045120,0
0x13d1C16e65Adb04c7e87c56D804c6c5fC3FBffB7,2794610,20,10,10,1397305,1397305,139730.5,139730.5,303142.505463767,303142.505463767,1045120,0
0x9f63D8C42CD762C36BB3a63a13fdC3b7EEefa853,2033492,4,2,2,1016746,1016746,508373.0,508373.0,201495.0,491627.0,1000000,0
0xAe3D6Ba7a766C979b84e880118c5787A479305B5,633,1,1,0,633,0,633.0,0,0.0,0,633,633
0x48c04ed5691981C42154C6167398f95e8f38a7fF,701270990,257,128,129,351861186,349409804,2748915.515625,2708603.1317829457,6432689.080133835,8161998.626355771,77304047,2672189
0x6a2735Ea02AD591e2988f2b2Bea1b2cB4023170D,208002,2,1,1,104001,104001,104001.0,104001.0,0.0,0.0,104001,0
0xcd6Eddf26B765304563E196F7BA2baE1a9ab2090,208136,2,1,1,104068,104068,104068.0,104068.0,0.0,0.0,104068,0
0x0B4b58Bf0B1Cb6560DfEb8f61288bA15e612e5Dc,417570,3,2,1,208785,208785,104392.5,208785.0,324.5,0.0,208785,0
0x38CcD5bB3521a37475De29DAF84ef9efB5CB4605,1636684,4,1,3,818342,818342,818342.0,272780.6666666667,0.0,126714.69349509376,818342,0
0xDb73e5BdC75b0384Ed9D26bf7A049EC83dACE1DB,14074,1,1,0,14074,0,14074.0,0,0.0,0,14074,14074
0x0B69432de2B4751502e9ecBB85549346EfDe77fD,95095,2,1,1,47595,47500,47595.0,47500.0,0.0,0.0,47595,95
0x1cf3ED1bB50cE41eB978Be657B30e95c1e017362,65078,1,0,1,0,65078,0,65078.0,0,0.0,65078,0
0x7a114A27A734f17C768F3973ae54F371cab90bC9,10702,2,1,1,5351,5351,5351.0,5351.0,0.0,0.0,5351,0
0x6CF5c63D603D4B135C5A8c3DaB71F519F9e6e471,1024150,2,1,1,512075,512075,512075.0,512075.0,0.0,0.0,512075,0
0x1661638e6C49b47fFB5c9A8B2fB804e417DBBA2C,538,1,1,0,538,0,538.0,0,0.0,0,538,538
0x08d789cFa1Af3EDCb7c6c5fAB4f6905f1Dc84454,115146,3,2,1,57573,57573,28786.5,57573.0,25075.5,0.0,57573,0
0xaF7950129FB54ec329EBEeD7bf23774eE3c811dd,27536,2,1,1,12686,14850,12686.0,14850.0,0.0,0.0,14850,0
0xDEF171Fe48CF0115B1d80b88dc8eAB59176FEe57,123366476,84,39,45,61683238,61683238,1581621.4871794872,1370738.6222222222,843015.3154462053,915375.3980480185,3601000,0
0xeF13101C5bbD737cFb2bF00Bbd38c626AD6952F7,32480,4,4,0,32480,0,8120.0,0,7256.015263214376,0,19151,40143
0x9e8e6aDB404123799f6edDDEcF51885886095D68,2126281,2,1,1,1054557,1071724,1054557.0,1071724.0,0.0,0.0,1071724,0
0x1111111254EEB25477B68fb85Ed929f73A960582,242359426,221,113,108,121179713,121179713,1072386.8407079645,1122034.3796296297,2434650.6966912067,2493693.8839330515,14642577,1
0x3A2b5649d35DD0876ec332df174675C59C27b1b9,7520898,2,1,1,3760449,3760449,3760449.0,3760449.0,0.0,0.0,3760449,0
0x81153f0889Ab398C4acb42CB58B565A5392bba95,144152176,154,77,77,72076088,72076088,936053.0909090909,936053.0909090909,230984.0506398196,230984.0506398196,1261901,0
0x2F27E59bb935efBD69c150f2241E583D4C943B05,106473,3,3,0,106473,0,35491.0,0,24363.55989314096,0,53707,106473
0x1a520614B658B11fE01EB01176b783C7D95930c0,423230,4,0,4,0,423230,0,105807.5,0,112648.48498204492,300000,0
0x23eBCD701fd92867235aEB0174B7c444b9B2b3Ad,7520898,2,1,1,3760449,3760449,3760449.0,3760449.0,0.0,0.0,3760449,0
0x3B87f7D473550ef9e53e46Baae856608f8b8A0C4,13349402,9,9,0,13349402,0,1483266.888888889,0,1096394.4812783645,0,2809244,13349402
0xEAd050515E10fDB3540ccD6f8236C46790508A76,14921510,6,3,3,7460755,7460755,2486918.3333333335,2486918.3333333335,362459.8894280886,362459.8894280886,2817881,0
0x0B8a49d816Cc709B6Eadb09498030AE3416b66Dc,24430010,16,7,9,12217450,12212560,1745350.0,1356951.111111111,862046.9080367461,1045399.3887134922,2817881,4890
0xF602694451635aC680bfCd5C13Be1f2AD0992989,2653324,2,0,2,0,2653324,0,1326662.0,0,0.0,1326662,0
0xB4f34d09124b8c9712957b76707b42510041EcBb,26871,18,18,0,26871,0,1492.8333333333333,0,1495.9337942123866,0,5719,30294
0xBF296588E942790E0650b8071F2795fbc8A306eE,64205,2,0,2,0,64205,0,32102.5,0,22102.5,54205,0
0xF8f6d3a926856e5E90129085dFDeBBB59E2478A2,9483192,6,1,5,4741596,4741596,4741596.0,948319.2,0.0,675012.0149705189,4741596,0
0xbef5684d41CeA81784a35AdCd2B85E3d9f797599,9785528,3,2,1,4892764,4892764,2446382.0,4892764.0,1606428.0,0.0,4892764,0
0x3D5AE9c482E780EAAf4dba10f1C265cDe31EaF36,19034242,10,5,5,9517121,9517121,1903424.2,1903424.2,462640.2656450906,462640.2656450906,2568028,0
0x205121F2e874e4Ef9920B9B4737E12b1d4c361b1,1121658,4,1,3,560829,560829,560829.0,186943.0,0.0,49571.93928692589,560829,0
0x078fD8aB3b791078820cB3109805A16D7B0E16cF,2878106,2,1,1,1439053,1439053,1439053.0,1439053.0,0.0,0.0,1439053,0
0x276f538865DFA6Fc2452490EF4C614658BA33e53,5769448,4,1,3,2884724,2884724,2884724.0,961574.6666666666,0.0,736853.4538723121,2884724,0
0x472EFBC41A64B084Ea7e88306C9a71fcC05EDA92,228096,4,4,0,228096,0,57024.0,0,52022.89982786427,0,145459,228096
0x0Ac0e60408E98530c8C9BaD396e318c5beE640C3,12035389,2,0,2,0,12035389,0,6017694.5,0,1982305.5,8000000,0
0x7623fBC6f8aA993Fc757B36D390290b0E31FaD2D,24070778,4,2,2,12035389,12035389,6017694.5,6017694.5,1982305.5,1982305.5,8000000,0
0x59eD9F8998329464a011F2BC556446ade9bBd4a6,3352738,4,2,2,1676369,1676369,838184.5,838184.5,511787.5,511787.5,1349972,0
0x809ec41ea833cc359A93395da3F1EaEBfcF2138F,1676369,2,2,0,1676369,0,838184.5,0,511787.5,0,1349972,1855607
0xF3FA962bb1D13C1590a46d51C1e2c80386aF42fD,187666,2,1,1,93833,93833,93833.0,93833.0,0.0,0.0,93833,0
0x94408f8D839d5ada9ADF109B3be170eD0Ad46202,530172,2,1,1,265086,265086,265086.0,265086.0,0.0,0.0,265086,0
0x82b0315C400BB7C1dAd19aE44e0DFa9cdC6d4261,2158459,1,0,1,0,2158459,0,2158459.0,0,0.0,2158459,0
0x742d35Cc6634C0532925a3b844Bc454e4438f44e,10849775120,11,8,3,3843203490,7006571630,480400436.25,2335523876.6666665,733231321.177768,944361800.5264317,3006571630,23843203490
0x1A371682486c30c7bcA69A8dDb2498c2C1549273,4000000,5,2,3,2000000,2000000,1000000.0,666666.6666666666,900000.0,235702.26039551583,1900000,0
0xEEd8C83DC2de14Bb911bA0d3bb1fa197E171eBd7,9785528,2,1,1,4892764,4892764,4892764.0,4892764.0,0.0,0.0,4892764,0
0x39F6a6C85d39d5ABAd8A398310c52E7c374F2bA3,75561686,36,12,24,31903444,43658242,2658620.3333333335,1819093.4166666667,2299146.803302743,3353799.142844847,13626200,1477772
0x81502473742D7230564441c4F81CFF8e40884E96,2035200,3,2,1,1017600,1017600,508800.0,1017600.0,491200.0,0.0,1017600,0
0xb967Bc906ac617cD37bda1f7e7C14916C2AFF920,187666,2,1,1,93833,93833,93833.0,93833.0,0.0,0.0,93833,0
0x8CAEE74Ad17b505d950Ca9fdd0Bc357496f73b3D,1074454,4,2,2,542227,532227,271113.5,266113.5,261113.5,166113.5,532227,10000
0x9b276Cb0AD161b843Ae49AF771686427C126c91E,1064454,4,2,2,532227,532227,266113.5,266113.5,166113.5,166113.5,432227,0
0x8B41BcEEb9858cFBA8139f7C87e2b002B92a3d00,1072518,5,3,2,536259,536259,178753.0,268129.5,183465.28420566837,258129.5,526259,0
0x9a49830db2f79533Ff5A101589465e7183A7c4AE,8491828,2,1,1,3745011,4746817,3745011.0,4746817.0,0.0,0.0,4746817,0
0x3C02290922a3618A4646E3BbCa65853eA45FE7C6,13141472,29,14,15,5609443,7532029,400674.5,502135.26666666666,421653.6643979867,575148.7681891781,2581617,1467194
0x288Db0d6F833eC932B2371CFAa45b222770dDEE8,1378524,2,1,1,689262,689262,689262.0,689262.0,0.0,0.0,689262,0
0x4c1ece38084B64D20C3210c195e5f61683f00325,5319,1,1,0,5319,0,5319.0,0,0.0,0,5319,5319
0x26071cdcE61473253970bD7B678101E58A1e47cB,144647989,146,86,60,72808392,71839597,846609.2093023256,1197326.6166666667,1347590.4679996145,1605560.5887976543,8056800,968804
0x4426B9F5d36E7890EC40d744d9d316a921E42442,247395536,54,27,27,123697768,123697768,4581398.814814814,4581398.814814814,2043802.9712273406,2043802.9712273406,8151975,0
0xd0e5191eA66F2d5B994B158d237E5c8C53754450,76416540,34,17,17,38208270,38208270,2247545.294117647,2247545.294117647,671387.622764513,671387.622764513,2713000,0
0xACa64c90bc51A70000A72d5C2039368C4414f3EA,8177742,4,2,2,4088871,4088871,2044435.5,2044435.5,523592.5,523592.5,2568028,0
0x2DCDe5A147F78Cd7F211A84f8d65EC8d5CdAF0e7,5301198,2,1,1,2650599,2650599,2650599.0,2650599.0,0.0,0.0,2650599,0
0x33bcb161f8E727E968cdaF36737f0102cb80Ba9B,708040,4,2,2,354020,354020,177010.0,177010.0,173958.0,176960.0,353970,0
0x8f053c16beC4f980C3D94D38F815d5b9346e67B0,36114796,61,34,27,18057398,18057398,531099.9411764706,668792.5185185185,224314.9599605746,422424.1499267777,1878834,0
0x461D39A123C44934E8e48EFEbE80F911dAFAC4Ef,8044,1,1,0,8044,0,8044.0,0,0.0,0,8044,13924
0x279A30dC83C43238aB3e2F247DeD8990bA82844D,2853086,3,0,3,0,2853086,0,951028.6666666666,0,702191.9274506713,1733086,0
0xcbF04EaC5a3443941CE6A41ff38D7E238406f0E4,2427075,2,1,1,260209,2166866,260209.0,2166866.0,0.0,0.0,2166866,0
0x23CA645fccFd4FFa167acd79857a63A68B3d67a8,35000,1,0,1,0,35000,0,35000.0,0,0.0,35000,0
0x54d5c3DE0a34e978bB023ee97809E3B32c81c3Ad,4611234,68,66,2,2305617,2305617,34933.59090909091,1152808.5,535.4072077392809,632191.5,1785000,0
0x480b9DEA52E053BEEFaC15ac3Dcb4c124475e024,35000,1,0,1,0,35000,0,35000.0,0,0.0,35000,0
0xD81c7064FebF3eBe4F64E6f35634035D62281DBF,35000,1,0,1,0,35000,0,35000.0,0,0.0,35000,0
0xf69c8d4F2f0Cfd264788C109ec47bc67c94653FC,35000,1,0,1,0,35000,0,35000.0,0,0.0,35000,0
0xB98dcbBbd0266427622F961cA94500DC4dB5273e,35000,1,0,1,0,35000,0,35000.0,0,0.0,35000,0
0x14e69109149c5179e8245DdAb7e4d93C141964fa,35000,1,0,1,0,35000,0,35000.0,0,0.0,35000,0
0xE046D1A56dB328481D17E24D1bf2dAc2cEcA2E9c,35000,1,0,1,0,35000,0,35000.0,0,0.0,35000,0
0xAC08614F20069AC4631486f6FE9838Ba80cfFe3b,35000,1,0,1,0,35000,0,35000.0,0,0.0,35000,0
0xb5cec7f562c0Fb024a2D041D41CeF9eB3DB2c91E,35000,1,0,1,0,35000,0,35000.0,0,0.0,35000,0
0xd08Ab6C67c83594A834982CEE9133e956703aE5D,35000,1,0,1,0,35000,0,35000.0,0,0.0,35000,0
0x00D1Af3b4e14501b9CB47c43667B1c47902Fb32a,35000,1,0,1,0,35000,0,35000.0,0,0.0,35000,0
0xaCe0885EC7acAE81c8A32f92FE098C087C0283d1,35000,1,0,1,0,35000,0,35000.0,0,0.0,35000,0
0x06BD9D21F1CA7ab920ECE0aE425634Ed73894B80,35000,1,0,1,0,35000,0,35000.0,0,0.0,35000,0
0xE9D54231D6f6759E45A517e3B9066e23F0CB73c7,35000,1,0,1,0,35000,0,35000.0,0,0.0,35000,0
0x05B77Cd509b98aA9a0421FC47b61adeBa5d34350,35000,1,0,1,0,35000,0,35000.0,0,0.0,35000,0
0x908d9d29A0c48B36FDCfa998B7eAb1694E4E0195,35000,1,0,1,0,35000,0,35000.0,0,0.0,35000,0
0x899544FF87C5e99D99d432d6Ac9647Cd1979cA85,35000,1,0,1,0,35000,0,35000.0,0,0.0,35000,0
0xAf1400e3d27046BBbfeE2b17aF732AB162dc6acA,35000,1,0,1,0,35000,0,35000.0,0,0.0,35000,0
0x81cCa53d760F6b7073624841ec2F274E147BA18D,35000,1,0,1,0,35000,0,35000.0,0,0.0,35000,0
0x0bEBf7a24B90162f341DaFaBcBFaee7FE99Fd0B1,35000,1,0,1,0,35000,0,35000.0,0,0.0,35000,0
0xDE693f7b3aeC8CA4e92833c453fc7Bcc373Cf96C,35000,1,0,1,0,35000,0,35000.0,0,0.0,35000,0
0x1742B1F1355aF5Ae9c95c53359eC96DDa9F5601c,35000,1,0,1,0,35000,0,35000.0,0,0.0,35000,0
0x8B6425258b9C4D8f86Db891aD6798401f7931153,35000,1,0,1,0,35000,0,35000.0,0,0.0,35000,0
0xD794742aeF5631CE46Fed5973254F87f88f0C4e8,35000,1,0,1,0,35000,0,35000.0,0,0.0,35000,0
0xB91C38bDf7475E791c1F8Ed0945114C73B4a7ba3,35000,1,0,1,0,35000,0,35000.0,0,0.0,35000,0
0x7e42Bb3FA90d256b4419040D1F79714E50372E06,35000,1,0,1,0,35000,0,35000.0,0,0.0,35000,0
0x90D214BB66862C32D2e704d167cf6EDC91b7A441,35000,1,0,1,0,35000,0,35000.0,0,0.0,35000,0
0x3203ff20E8649633194616d18F128a6456D62B4a,35000,1,0,1,0,35000,0,35000.0,0,0.0,35000,0
0x0c4569C5F9DCe58e40Ab9b1Ab1eC43ed275001aE,35000,1,0,1,0,35000,0,35000.0,0,0.0,35000,0
0x00A2fD1f64F4269904476eaB5adE2cA936ceCB69,35000,1,0,1,0,35000,0,35000.0,0,0.0,35000,0
0x87B929AC6C13b320Edc89a1F4c668AEd0b0744F1,35000,1,0,1,0,35000,0,35000.0,0,0.0,35000,0
0xb888d60F64427c89C0B478a7666E868Fb354039C,35000,1,0,1,0,35000,0,35000.0,0,0.0,35000,0
0xcB04917d5fb77a3C2143374aD9D555ddE49f7e6c,35000,1,0,1,0,35000,0,35000.0,0,0.0,35000,0
0x5ac7B0BeD26B3C8f2EF8bdE1FBa6F02248C52Bfb,35000,1,0,1,0,35000,0,35000.0,0,0.0,35000,0
0x178a3855489EF785E0d1CA9F9c8dFd9A6C41ff26,35000,1,0,1,0,35000,0,35000.0,0,0.0,35000,0
0xc4bb582Cb4b8f19337540D79763733Df037f27ce,35000,1,0,1,0,35000,0,35000.0,0,0.0,35000,0
0xe8b4DDd28826156e470859c04D4F682708D50262,35000,1,0,1,0,35000,0,35000.0,0,0.0,35000,0
0x835cF7d8e71bE801fcc3d5ddA6039dbc77D63621,35000,1,0,1,0,35000,0,35000.0,0,0.0,35000,0
0xF865d26752c72721b849fE9C781EF9c081aFA41F,35000,1,0,1,0,35000,0,35000.0,0,0.0,35000,0
0x41184B648e822078790A0e17F9564C459D32e65A,35000,1,0,1,0,35000,0,35000.0,0,0.0,35000,0
0xC679e0B06cF008F866F0fdBe0fa6DBa878d2202c,35000,1,0,1,0,35000,0,35000.0,0,0.0,35000,0
0x134DeFB970cf9A64E0392C41819550350C8B7e3C,35000,1,0,1,0,35000,0,35000.0,0,0.0,35000,0
0x15B404d92768F3E805b7E8b37A01107c76D7623E,35000,1,0,1,0,35000,0,35000.0,0,0.0,35000,0
0xb84EFf01fDa13E45f2Bad60539A094e31549Bb55,35000,1,0,1,0,35000,0,35000.0,0,0.0,35000,0
0xb644a9F8A813C0D0CEe9220aE33198a0633820AE,35000,1,0,1,0,35000,0,35000.0,0,0.0,35000,0
0xd2F56f5D8357F2CFD90F638c38E06517d1afF15a,35000,1,0,1,0,35000,0,35000.0,0,0.0,35000,0
0x2F1dc11ba6B2bCD091265A011b2757725edd0BE2,35000,1,0,1,0,35000,0,35000.0,0,0.0,35000,0
0x208d0701dD6dc6e85FbE630a9EC7F676CFA12D2A,35000,1,0,1,0,35000,0,35000.0,0,0.0,35000,0
0x34Da51579f4B1fa5cb3C716e936660770B5BC1F0,35000,1,0,1,0,35000,0,35000.0,0,0.0,35000,0
0x9A5cFF86379195312B59e0268AaF90Bd857F16cd,35000,1,0,1,0,35000,0,35000.0,0,0.0,35000,0
0x199B758a1eE51cF427Ba844863bb74DEB0fF4e9E,35000,1,0,1,0,35000,0,35000.0,0,0.0,35000,0
0x74ee84613837d0E2Eeb932017fDAbE86232960C5,35000,1,0,1,0,35000,0,35000.0,0,0.0,35000,0
0x6D5AAC0cFf866B39354cd4Ff0FB411FECb3b948E,35000,1,0,1,0,35000,0,35000.0,0,0.0,35000,0
0x29d4C9D771531B2ED928fbB23b40be7E0Ba7a590,35000,1,0,1,0,35000,0,35000.0,0,0.0,35000,0
0x88f155b51d0C46960daE7ea0726D1Ca33e0A30bB,35000,1,0,1,0,35000,0,35000.0,0,0.0,35000,0
0x36B97a67efFFAFbD17AB1Cf033e5D3Bcf0F16bdB,35000,1,0,1,0,35000,0,35000.0,0,0.0,35000,0
0xC7EC5Ab974C47CC3D33ad0E92Fd55Ba117c9c77E,35000,1,0,1,0,35000,0,35000.0,0,0.0,35000,0
0xeE115eCA54E4bCBf48ac04f79ECe274E36fa21c3,35000,1,0,1,0,35000,0,35000.0,0,0.0,35000,0
0x57da907720bE53c5f6f99aE03D52e802D592e7C7,35000,1,0,1,0,35000,0,35000.0,0,0.0,35000,0
0x5d2731d0EeBa40d8881a9064F02928A82628BF70,35000,1,0,1,0,35000,0,35000.0,0,0.0,35000,0
0xe57e033F6af990381eef88Ee95302D5e2f94c387,35000,1,0,1,0,35000,0,35000.0,0,0.0,35000,0
0x999AfaAf112C18D40e8D2FddF8e8300913b3d809,35000,1,0,1,0,35000,0,35000.0,0,0.0,35000,0
0x4Fa69051ec0d96bc871338D35a45c461b23738E3,35000,1,0,1,0,35000,0,35000.0,0,0.0,35000,0
0xDD936994eeCA2ee8648Ee2dD0f8C6C4128B2ba5d,35000,1,0,1,0,35000,0,35000.0,0,0.0,35000,0
0x07e30cb4d8707A7A2780568e93cC7892c5F1c732,35000,1,0,1,0,35000,0,35000.0,0,0.0,35000,0
0x1BddF5d18872878eE619853630F6508B78749253,30617,1,0,1,0,30617,0,30617.0,0,0.0,30617,0
0x60AFC7AeC0f44F3416e1439A739980d2fF300440,2581617,1,1,0,2581617,0,2581617.0,0,0.0,0,2581617,2650417
0xec33F6bFf72F7328F7532d5B70F76047Ea3fdaba,1098448,8,8,0,1098448,0,137306.0,0,11905.251782301792,0,156355,1098448
0x8A9B042325df3eB2CC8E6B7e6Eb6C19D0E64D6a6,204400,2,1,1,102200,102200,102200.0,102200.0,0.0,0.0,102200,0
0xFFc0693DA60136700f4Ee1180A67F0948B1BaA19,1995600,2,1,1,997800,997800,997800.0,997800.0,0.0,0.0,997800,0
0xb7a8aF8450E1bc805e481fac23eA67f7f2d2652A,1995600,2,1,1,997800,997800,997800.0,997800.0,0.0,0.0,997800,0
0x88c7a2e87e822BbAb42F5bEffe6F52344a0263B0,22971980,6,3,3,11485990,11485990,3828663.3333333335,3828663.3333333335,3657125.9257540233,3657125.9257540233,8992630,0
0x88fC50577749BD27b242B578B8A0B6A738EB8683,22510375,13,3,10,11485990,11024385,3828663.3333333335,1102438.5,3657125.9257540233,1722303.3348885584,8992630,618110
0xe79F6334107a5Fca525104e11bD6ab9F160eDfd8,104374,2,1,1,52187,52187,52187.0,52187.0,0.0,0.0,52187,0
0x5B47b295176aB761B5423B3ebeeb54BeABA9d0c7,52187,1,1,0,52187,0,52187.0,0,0.0,0,52187,52187
0x5d3a165ED4C73c8049E7a3C4bd3963AfC31ccCf3,2187800,3,1,2,1093900,1093900,1093900.0,546950.0,0.0,43050.0,1093900,0
0x4d9B5806DC3F1A831ba832deF3A6B4025c54FF59,208885,4,0,4,0,208885,0,52221.25,0,31428.599995664776,100000,0
0x028Ab5c0F5cf1C4800BC9c601B0d42c7456C259A,212428,4,2,2,106214,106214,53107.0,53107.0,0.0,0.0,53107,0
0xB172CadfF56Fd532d81472391742e3Fe9147e40e,3668774,3,1,2,1497591,2171183,1497591.0,1085591.5,0.0,585591.5,1671183,0
0xD9408f29026E32852AFf8C5C9C8Ea834b44b4e1C,1041972,2,1,1,520986,520986,520986.0,520986.0,0.0,0.0,520986,0
0x736ACA81f2D9edf049c9f4a358fc90A34483B737,35000,2,1,1,17500,17500,17500.0,17500.0,0.0,0.0,17500,0
0xC585989A1e37a4aB36ED52476939D092Bc503471,8076,1,1,0,8076,0,8076.0,0,0.0,0,8076,8076
0x4D9D142B13fbA17b5eaD54448c84308102390158,19804,1,0,1,0,19804,0,19804.0,0,0.0,19804,0
0x01F95DED58a3404d744A87949cAB826D6B13f642,24400,2,1,1,12200,12200,12200.0,12200.0,0.0,0.0,12200,0
0x94Ac2C2928c296412901a1e0155eDF6f2546416c,24400,2,1,1,12200,12200,12200.0,12200.0,0.0,0.0,12200,0
0xe3Da7Ac6d2B2EDd697910732093A4DF9040220BD,106214,2,1,1,53107,53107,53107.0,53107.0,0.0,0.0,53107,0
0xc569ef09f3508A0c7A01337f337099bb2429729f,1035800,2,1,1,517900,517900,517900.0,517900.0,0.0,0.0,517900,0
0xB8001C3eC9AA1985f6c747E25c28324E4A361ec1,1068414,4,2,2,541900,526514,270950.0,263257.0,246950.0,219291.0,517900,15386
0x8b1cb9cd8BD0283c392e6fAbC3FB88C76f989093,1366269,5,5,0,1366269,0,273253.8,0,229358.95471195364,0,660860,1366269
0xD4Dcd2459BB78d7a645Aa7E196857D421b10D93F,7970987,13,3,10,5467721,2503266,1822573.6666666667,250326.6,74410.84096793663,349730.5636838737,1926600,12292624
0xC51e2a5dBa15dda5F922B54232fEf035308D18B4,186128,3,2,1,93064,93064,46532.0,93064.0,44999.0,0.0,93064,0
0x86199356FC5eE561eE64ecfE0De7Dd9ce55767c5,5000000,1,1,0,5000000,0,5000000.0,0,0.0,0,5000000,10000000
0x7bb592d57120088d11A551A24BC8E8578dAD4871,43067,2,0,2,0,43067,0,21533.5,0,21013.5,42547,2
0xe76A8D148479850dE44ac7Eb7796509830941C97,43067,2,2,0,43067,0,21533.5,0,21013.5,0,42547,43067
0xD2c35f140DA2D2b700e83030052e068d8743045A,194432,2,1,1,97216,97216,97216.0,97216.0,0.0,0.0,97216,0
0xa002fE1Cb6359eAa46609a556f6561d81365e1Fe,2238134,2,1,1,1119067,1119067,1119067.0,1119067.0,0.0,0.0,1119067,0
0x4BB71bf0C637a4eE7674138dB2eA6fC4d6133974,718836,3,3,0,718836,0,239612.0,0,38896.43096737797,0,290313,718836
0xE1A2cBC255d51E822c5935087BCFeDf789Ad1496,1063704,4,2,2,511573,552131,255786.5,276065.5,162431.5,275965.5,552031,0
0x1f4001207Df87Abb65DF00b3B733258871aC9467,3852186,4,1,3,1926093,1926093,1926093.0,642031.0,0.0,115704.26348526085,1926093,0
0x3DCD7562804d5bb18f133E3e9acCE616519AA12b,710778,2,2,0,710778,0,355389.0,0,352428.0,0,707817,968561
0xf45eB6639a9B391f5b28207A5f1Ae17592cF3CF7,33800,1,0,1,0,33800,0,33800.0,0,0.0,33800,0
0x6bc9272B7db610ea8727d60377768c8dAC994a11,33800,1,1,0,33800,0,33800.0,0,0.0,0,33800,33800
0x505987580015fBEB04F5B85660b302B4d626bC7F,3058494,1,1,0,3058494,0,3058494.0,0,0.0,0,3058494,3058494
0x77d462E927C54aa3217b824a8EbB444fBC0D93d5,7194404,2,1,1,3597202,3597202,3597202.0,3597202.0,0.0,0.0,3597202,0
0x57EE3AdD2E680F468a5ae3C0b6d8b0D3ACd921Ce,5721,1,1,0,5721,0,5721.0,0,0.0,0,5721,5721
0x0F4B19015CDc50082d6d95F7A942A9Ea0D8239b5,862598,2,1,1,431299,431299,431299.0,431299.0,0.0,0.0,431299,0
0x6FF8f88844D9f8b20Fce303E0DF3CCf9b6A38672,5248,1,1,0,5248,0,5248.0,0,0.0,0,5248,5248
0x26787A5601fFFA13fd421c927dE222aD572C50E7,2027456,3,2,1,1013728,1013728,506864.0,1013728.0,5675.0,0.0,1013728,0
0x5E2B27b25AC8739e3b324B99980033621b3f6633,1032328,2,1,1,516164,516164,516164.0,516164.0,0.0,0.0,516164,0
0xfB64d5dEa790996783540Fc8641E7F0e6A185465,3035,1,1,0,3035,0,3035.0,0,0.0,0,3035,3035
0xa1Cf5F211782A45776f125EbF83E71bC85533cBc,1601202,2,1,1,800601,800601,800601.0,800601.0,0.0,0.0,800601,0
0x2B50bb7E67C03e3FA7C6a8Fd14060878E323B5E4,97582,2,1,1,48791,48791,48791.0,48791.0,0.0,0.0,48791,0
0x17F6bB04EAC73968419e3aEB623d3F11d8cCD0CD,97582,2,1,1,48791,48791,48791.0,48791.0,0.0,0.0,48791,0
0x018cc3834A6fe409e217FA0EC1211C5C7Bfb83a9,20570,2,2,0,20570,0,10285.0,0,5135.0,0,15420,20570
0x3250A2576611f3bFbdeAd0005b9E3A2a1F6FAf50,1000000,1,1,0,1000000,0,1000000.0,0,0.0,0,1000000,1000000
0x5705c51ba439391A79Ebd86420cd295e899C08f6,16799,1,1,0,16799,0,16799.0,0,0.0,0,16799,16799
0xC302d00AB402dad479986160967875a7eE2D948d,405836,2,1,1,202918,202918,202918.0,202918.0,0.0,0.0,202918,0
0x6d467c331B81B75A379903Fe86898f700249f5FA,36810919,7,7,0,36810919,0,5258702.714285715,0,3358455.848696231,0,9861520,63501009
0x4000A69E1a07f57d3F61DaE7cF86D23eb6B0662c,2600000,1,1,0,2600000,0,2600000.0,0,0.0,0,2600000,5909800
0xEE459c9E50f5e2cB58D4D76f0B68f75C66A86650,491760,1,0,1,0,491760,0,491760.0,0,0.0,491760,0
0x7ED0Edfdf684B7b0DF1471f1bA5b3BAfD0bee26E,107,1,1,0,107,0,107.0,0,0.0,0,107,107
0x60FA0FF6444749AE5391d8402ba93F2C46CE4224,1051944,3,2,1,525972,525972,262986.0,525972.0,50121.0,0.0,525972,0
0x3bb34f3F577d72284C0C1C9bCb9EF8a6c4B836BE,99808,1,1,0,99808,0,99808.0,0,0.0,0,99808,147789
0xD9043A84c2a533Ff9AF2eedB87478492fe328C1A,5923606,5,2,3,2252621,3670985,1126310.5,1223661.6666666667,379160.5,316305.3623829704,1670985,2252621
0xA51cE68D5EF22231650110dDD83bca4535df8E68,7341970,6,3,3,3670985,3670985,1223661.6666666667,1223661.6666666667,316305.3623829704,316305.3623829704,1670985,0
0xb48f58936E95ef98CfAEdA9d225f4678DFa22916,3538000,4,2,2,1769000,1769000,884500.0,884500.0,100600.0,100600.0,985100,0
0xc31722df8D459ec0E87B34CE515CDd17f754E983,1735000,2,1,1,867500,867500,867500.0,867500.0,0.0,0.0,867500,0
0x216aa5e0F17A5C25cbf1aBe2A76d3aC4c3292D2A,197500,1,1,0,197500,0,197500.0,0,0.0,0,197500,197500
0x23529B46Bb5fdB9F9d0427e9a35115551b72581B,7799098,10,5,5,3899549,3899549,779909.8,779909.8,371810.02435512684,371810.02435512684,1157500,0
0x74c05cA3cE750Ad155771F79a7b4d0E88ffB2e5F,1240000,2,1,1,620000,620000,620000.0,620000.0,0.0,0.0,620000,0
0xdF8b7aceB7A720A1f66EC7797B735B94632794fE,7822000,4,2,2,3911000,3911000,1955500.0,1955500.0,755000.0,755000.0,2710500,0
0x3E0827f159feeE99d86b6a690BC5984537be58bd,340700,1,1,0,340700,0,340700.0,0,0.0,0,340700,340700
0x70A34f9Fb0fC90Ba44BB9aDfe3A71CEB9882253a,4382082,8,5,3,2191041,2191041,438208.2,730347.0,372264.4217555043,308161.45304801944,1157831,0
0x4ef94ba031212913E7688fD97c5145867d8Fcb52,3417600,2,1,1,1708800,1708800,1708800.0,1708800.0,0.0,0.0,1708800,0
0xd3F00384427Bae9e6cbaAB2245A52E9D84D950aF,5554000,2,1,1,2777000,2777000,2777000.0,2777000.0,0.0,0.0,2777000,0
0x33df0670007080a910e6a2e1810df61733Fe66bf,1708200,2,1,1,854100,854100,854100.0,854100.0,0.0,0.0,854100,0
0x6F9b13c16A9b0AfCe0fE43d2737DEB604C4442d1,1707400,2,1,1,853700,853700,853700.0,853700.0,0.0,0.0,853700,0
0xF71AfE21Cd32959113Fc47aE2EF886B43A9413d5,20000000,3,0,3,0,20000000,0,6666666.666666667,0,2399942.34560379,10000000,0
0x72E5263FF33D2494692D7F94A758aA9F82062F73,58205724,16,5,11,37998416,20207308,7599683.2,1837028.0,5510137.360769091,1538338.799373591,16999208,17791108
0x6503c3e96b1193c3314638296E77078408190024,33137336,7,4,3,16568668,16568668,4142167.0,5522889.333333333,3185440.390465579,3413350.4548880155,9515505,0
0xB5FB3c304E06Fe3773f3e6ba68a86AC16b97f579,3173600,3,2,1,1586800,1586800,793400.0,1586800.0,777500.0,0.0,1586800,0
0xb5F9C59De1b5CC89bB280a49a790FfF99e44a1B7,11106800,2,1,1,5553400,5553400,5553400.0,5553400.0,0.0,0.0,5553400,0
0xC41763da424733f2411410059797141413b8eA72,5720600,4,2,2,2860300,2860300,1430150.0,1430150.0,199450.0,199450.0,1629600,0
0xBb760b7BaA2314c76bED8A9E7a37e66f45ED97e9,347800,2,1,1,173900,173900,173900.0,173900.0,0.0,0.0,173900,0
0xc5241c82FCB084CB7f45C8dB63DD058c998512DD,967600,2,1,1,483800,483800,483800.0,483800.0,0.0,0.0,483800,0
0x1689a089AA12d6CbBd88bC2755E4c192f8702000,63806888,24,12,12,31903444,31903444,2658620.3333333335,2658620.3333333335,2299146.803302743,2299146.803302743,7000000,0
0x0c13DB3C27FD92493700d501E030bf8a5B788c57,22976400,4,2,2,11488200,11488200,5744100.0,5744100.0,3078000.0,3078000.0,8822100,0
0xD945bD261392702DddB8783FD06b850cc22AC19d,888573,2,1,1,498573,390000,498573.0,390000.0,0.0,0.0,498573,896841
0x589590EFc7F22ac65bd6947F950e925f4B4d81e8,780000,2,1,1,390000,390000,390000.0,390000.0,0.0,0.0,390000,0
0xDC2547f28fF2768f1F8e779ACA91aB408b37f382,294158,7,6,1,147079,147079,24513.166666666668,147079.0,23870.292390449587,0.0,147079,0
0x005E41FBa056ACbb17386Ce0eaAeB9Ddc1B9b7f7,719940000,12,6,6,359970000,359970000,59995000.0,59995000.0,23094010.76758503,23094010.76758503,89995000,0
0x3451975f3eD43308e54343d5EcC1C45d4c0e24e8,391076,1,0,1,0,391076,0,391076.0,0,0.0,391076,0
0x1B18382F7c1D527aE21F1667b94B8Fd3815ECcD2,1998416,2,1,1,999208,999208,999208.0,999208.0,0.0,0.0,999208,0
0x3AA228a80F50763045BDfc45012dA124Bd0a6809,19536,2,1,1,9768,9768,9768.0,9768.0,0.0,0.0,9768,0
0x3208684f96458c540Eb08F6F01b9e9afb2b7d4f0,19536,2,1,1,9768,9768,9768.0,9768.0,0.0,0.0,9768,1
0xAAe841bf96cf87aF8Ce6A74AcE899efb8f6AeaDe,14815,2,2,0,14815,0,7407.5,0,2360.5,0,9768,14815
0xFAc7148d01960B43e56fa2E0D6228B5c55fd5767,5230632,2,1,1,2615316,2615316,2615316.0,2615316.0,0.0,0.0,2615316,0
0xBFCd86e36D947A9103A7D4a95d178A432723d6aD,165123907,19,8,11,76279036,88844871,9534879.5,8076806.454545454,15165371.27910246,10037596.751870135,39693460,0
0x974026E01660D11B5b5F08394806b619702Ac35C,174246379,58,11,47,88844871,85401508,8076806.454545454,1817053.3617021276,10037596.751870135,5775074.08817849,32000000,3443363
0x5E0ebb51427FA378e977cf39E756a67475d82e16,69686,3,2,1,34843,34843,17421.5,34843.0,455.5,0.0,34843,0
0x75FA78E564906A37c6c15a5b19f161322C3eB9B5,4257246,1,0,1,0,4257246,0,4257246.0,0,0.0,4257246,0
0xcB7292c4d94D73F84172C5dd280baE6eed48c273,8514492,2,1,1,4257246,4257246,4257246.0,4257246.0,0.0,0.0,4257246,0
0x4FF4f78d55e3eB836950E0311Aa0eEA704D42c12,35005224,3,2,1,18006016,16999208,9003008.0,16999208.0,7996200.0,0.0,16999208,1006808
0x5539613b23d715B47317406d468b86Cb3Ee5f2e6,571071,1,1,0,571071,0,571071.0,0,0.0,0,571071,571071
0x150d9A4D693bB45f3AaC3d4468aE8b055386288d,12242,1,1,0,12242,0,12242.0,0,0.0,0,12242,12242
0x0Ef878450C8FF6724CB2E719D9d8e401559B2d5f,4249310,2,1,1,2124655,2124655,2124655.0,2124655.0,0.0,0.0,2124655,0
0xd73518A1021C7d9a5B95C243f794718A9878b7C7,46086,1,1,0,46086,0,46086.0,0,0.0,0,46086,46086
0x780eBa76cA789cbdBea5ba270F6f2579718321c7,403305,1,1,0,403305,0,403305.0,0,0.0,0,403305,862552
0xb8d7B32aDa3A61Bc864e76347a7912989E292B37,509100,3,2,1,125600,383500,62800.0,383500.0,1900.0,0.0,383500,0
0x00853f8677fe3441322756971ec173b71A501272,148250104,61,33,28,74125052,74125052,2246213.696969697,2647323.285714286,2788277.1516546924,2620845.699960972,14600895,0
0x7D77797d0a0Cac72023f385935F34d709419f571,3044988,6,4,2,1522494,1522494,380623.5,761247.0,157981.95847390295,226563.0,987810,0
0xaB596adCDe5b10F8804a83b37b16311Ab4F8E40E,250302,1,1,0,250302,0,250302.0,0,0.0,0,250302,250302
0x8180e4c1f3D56b4f171B95C4a7CdAe3FeBc6bA33,974114,1,0,1,0,974114,0,974114.0,0,0.0,974114,0
0x8bE9bE7d6463065aaCF2718815e58ac4Ee89275C,1948228,2,1,1,974114,974114,974114.0,974114.0,0.0,0.0,974114,0
0x2d995DE72d6cF06C8d3ce891A49Be65D5c76dEA3,14592864,5,5,0,14592864,0,2918572.8,0,436024.8168420692,0,3734534,14592864
0xed14f99C8Ef5c7302Dcb2B0A45072f2Af95b25e6,1520372,1,0,1,0,1520372,0,1520372.0,0,0.0,1520372,0
0xba5a2aD4436e5c6F8e2532a20961226E9BBfB607,3040744,2,1,1,1520372,1520372,1520372.0,1520372.0,0.0,0.0,1520372,0
0xfA4E3eC7d587C6F80381AF6f9a6fcE393D0B1c28,81400,6,5,1,40700,40700,8140.0,40700.0,4864.401299235086,0.0,40700,0
0xDD91E70BB95B9E229082178fA1b4b4D3833E5153,928621,1,1,0,928621,0,928621.0,0,0.0,0,928621,928621
0xB07EE4Aaa7916D305d8fCB1D7Aa598Acbd648Ce8,1674825,2,2,0,1674825,0,837412.5,0,404369.5,0,1241782,1674825
0xEF8721B621446a598C08e80A3f30560cB5d24240,2640,1,0,1,0,2640,0,2640.0,0,0.0,2640,0
0x595b45c8D1a42FE93e6C2332501ffFb9eeCa3125,2640,1,1,0,2640,0,2640.0,0,0.0,0,2640,2640
0xB3b2b2347e6FD09cA7Ff850F79FF6F7074c535C6,50103,1,1,0,50103,0,50103.0,0,0.0,0,50103,50103
0xf081470f5C6FBCCF48cC4e5B82Dd926409DcdD67,7485137,10,5,5,3742569,3742568,748513.8,748513.6,1156933.3138317699,1156932.9159671445,3050028,1
0x4b7b44185F46F45E5348f72bF28f37Ff5B90C679,6100054,3,1,2,3050027,3050027,3050027.0,1525013.5,0.0,525013.5,3050027,0
0x63756A3C3BF677BAAB9D9e06457402ED05BE8570,190599675,244,123,121,95775023,94824652,778658.7235772358,783674.8099173554,167310.6305613428,159609.78693911276,948770,950371
0x58C2Fa3E7Cfe14A2E41Ce2F206ddfdE4daa21971,13996,4,2,2,6998,6998,3499.0,3499.0,2.0,2.0,3501,0
0x9a41DeA12BaC583Fa1b5e86480E0410226E8D8F1,2489043,7,0,7,0,2489043,0,355577.5714285714,0,117294.8608834738,500000,0
0x1d943D54B2A4623049B30725D6789b80BaC394B0,24046,2,1,1,12023,12023,12023.0,12023.0,0.0,0.0,12023,0
0xc914A198011d21Dc71A101A6d511F5fF61A04725,2013274,3,2,1,1006637,1006637,503318.5,1006637.0,500671.5,0.0,1006637,0
0x5D8EFE57Afc90BD1d28949EAbb19E27dd384098b,107425,1,1,0,107425,0,107425.0,0,0.0,0,107425,107425
0x7671D0A9CE2Da84A1d33d502AB0Eb5E285C5b3ba,301222,3,2,1,150611,150611,75305.5,150611.0,52577.5,0.0,150611,0
0xFa4a957aC53126B2823F2Bbd449C535162b4BAf3,22618,1,1,0,22618,0,22618.0,0,0.0,0,22618,22618
0xe19D817FD1BCEDAc50101EfcCEA9398BCa697565,1018069,1,0,1,0,1018069,0,1018069.0,0,0.0,1018069,0
0xBFD06611b23CF04dC005a0a7Ed3AE3580A4Ea5Be,2036138,2,1,1,1018069,1018069,1018069.0,1018069.0,0.0,0.0,1018069,0
0xaf9B571e36543BE67FbcC979F6d52A2dbB2E2C56,5845878,6,3,3,2922939,2922939,974313.0,974313.0,43393.55728676781,43393.55728676781,1017252,0
0xFA858B66B369191cbB312Fc11014aF6019591f4b,3676842,2,1,1,1838421,1838421,1838421.0,1838421.0,0.0,0.0,1838421,0
0x49eCb3f6EAF0a9B69f4650C76581f8a69B4A94C3,1077132,2,1,1,538566,538566,538566.0,538566.0,0.0,0.0,538566,0
0x8239D0F65D7bf30AC5AD26C959673EEF64dAb46e,14671150,4,2,2,7335575,7335575,3667787.5,3667787.5,24697.5,24697.5,3692485,0
0x9f3B158a76e9c517857252386f5cE72Ef9a5f696,8108,1,0,1,0,8108,0,8108.0,0,0.0,8108,0
0xdA278B74bbD624b8384dc3a6AA9E30C46E35067A,8108,1,1,0,8108,0,8108.0,0,0.0,0,8108,8108
0x03F911AeDc25c770e701B8F563E8102CfACd62c0,3676842,2,1,1,1838421,1838421,1838421.0,1838421.0,0.0,0.0,1838421,0
0x789d669DE103627f47b02f5404444510F27f1421,7385164,4,2,2,3692582,3692582,1846291.0,1846291.0,1796799.0,1796799.0,3643090,0
0x0b3E4D65d2AA7d4658449713b75858Ca71B39B1D,772355,1,1,0,772355,0,772355.0,0,0.0,0,772355,772355
0xCDf2198200D95831d9Be66f05FB5Fb42e9d8a5aF,17902,1,0,1,0,17902,0,17902.0,0,0.0,17902,0
0xb4af5Fd36CC78271f248b3976d930F64096EF388,17902,1,1,0,17902,0,17902.0,0,0.0,0,17902,17902
0x05F77C3aD3D6Dd7c8547CA2722828e516D7e0FAd,105074,2,1,1,52537,52537,52537.0,52537.0,0.0,0.0,52537,0
0x157bc4B7a190E3106ea772662e7C6aEFE724F722,4951974,2,0,2,0,4951974,0,2475987.0,0,2375987.0,4851974,0
0x19148dC0CA9A606D193C6867E376E2d5F6B9656F,9903948,3,2,1,4951974,4951974,2475987.0,4951974.0,2375987.0,0.0,4951974,0
0x315E2E2EB4da7a3A8FB30a329e6D8254eFb98C09,552131,2,2,0,552131,0,276065.5,0,275965.5,0,552031,552131
0xC35bf065c755C4eC5DAF93CEE18d6FDd7698d763,27821,1,1,0,27821,0,27821.0,0,0.0,0,27821,27821
0x3972ACD8c32f269bB219C7ef1fb23BDd5d972303,29022,1,1,0,29022,0,29022.0,0,0.0,0,29022,29022
0xE4aF98C8717c5f8c8423962B16585BA567267105,1930000,2,0,2,0,1930000,0,965000.0,0,585000.0,1550000,3471
0xf052a6a20c95FC843bCEF91be8F1F9bCdd8472FA,2074,1,1,0,2074,0,2074.0,0,0.0,0,2074,2074
0xc45aa635efF50dCB7B14067B103f759229C6E442,206160000,17,9,8,103080000,103080000,11453333.333333334,12885000.0,6091711.126148748,4855464.704845459,25000000,0
0xcE178dCAAe8559F676333255d2cb6b5Dbe705184,1528000,2,1,1,764000,764000,764000.0,764000.0,0.0,0.0,764000,0
0x9990Ba857d66E6E23432B6dce236e760c9a0713A,35000,1,0,1,0,35000,0,35000.0,0,0.0,35000,0
0x2DB871C6427739640607eeC851F08056b8182b11,1500450,4,3,1,1430450,70000,476816.6666666667,70000.0,624823.1220824729,0.0,1360450,1360450
0xFFd0168eAb0d8C5aE3d3e5E7D1D6D414490A430a,35000,1,0,1,0,35000,0,35000.0,0,0.0,35000,0
0xFBA3CaD55a7A745869dC483801E7854AD42Ff72C,262236,1,0,1,0,262236,0,262236.0,0,0.0,262236,0
0x2fA0fD7F2Fb7377b22ceFD59F0A3C37e65DBD513,2004684,1,0,1,0,2004684,0,2004684.0,0,0.0,2004684,0
0x250BfCa18818b8bE8e8BbB0e64D8CDF8A8e520cf,4009368,2,1,1,2004684,2004684,2004684.0,2004684.0,0.0,0.0,2004684,0
0xB3055F3eb43433257d7F21107337e9FD51F1DA7e,1500403,3,3,0,1500403,0,500134.3333333333,0,379426.0005238908,0,972132,1974404
0x0E0afAfBa053B59Dc8fCf05Af574d4e6e007302C,2014021,1,0,1,0,2014021,0,2014021.0,0,0.0,2014021,0
0x6F2819E88603dF47Ef0A54Ca65a8B7fABCb0a8c5,526338,2,1,1,263169,263169,263169.0,263169.0,0.0,0.0,263169,0
0x4Aef18AB933E73D553E198946C2e2C9D1deC1710,8658,2,1,1,4329,4329,4329.0,4329.0,0.0,0.0,4329,0
0x879fdD3c36705a0A68BC5cbb28D1a4609D42BE87,2296393,6,2,4,869145,1427248,434572.5,356812.0,54971.5,226917.08473360926,653624,0
0xdAAf7050e089174AaEb16235b49ECb084943246B,24374542,14,14,0,24374542,0,1741038.7142857143,0,814773.0472708711,0,4052640,24374542
0xD42661D4e7cC5e9764A24b66FB89DBe7b5D89aE1,21332422,2,1,1,10666211,10666211,10666211.0,10666211.0,0.0,0.0,10666211,0
0x8E36f3Fd4E8Ae76dDB4e79793dFD43A2D239D445,376318,3,0,3,0,376318,0,125439.33333333333,0,53601.48655484183,200000,0
0x57150bf8F636514cE1c94522F5aDD00247369443,19151800,2,1,1,9575900,9575900,9575900.0,9575900.0,0.0,0.0,9575900,0
0x04907dD5165e3d168B2190e7C840B2D0E1A6a9cC,3774000000,33,17,16,1887000000,1887000000,111000000.0,117937500.0,155667821.29982835,160771759.31658515,505000000,0
0xE5bec8FC570D864a928C7aa2552C28403053953D,536018,8,3,5,268009,268009,89336.33333333333,53601.8,58866.97583157772,10267.84139729476,171629,0
0x2a3DD3EB832aF982ec71669E178424b10Dca2EDe,278009,4,2,2,96380,181629,48190.0,90814.5,10905.0,80814.5,171629,9995025
0xe0AEe3790d4C7265aC97acF20Cbff78fb220CC75,3111274,3,2,1,1555637,1555637,777818.5,1555637.0,375568.5,0.0,1555637,0
0xA25177eB0328cb59334e94A9a1116e3b1ea62158,48085,1,1,0,48085,0,48085.0,0,0.0,0,48085,94695
0x30aD19A33eAAC39EEF50C612c5b4e5347F4BF918,138394215,9,2,7,37894215,100500000,18947107.5,14357142.857142856,11638847.5,9026604.668242354,35000000,60775635
0x744ee4D623607663E8fcF734d34C709D1CEBd619,10000000,2,1,1,5000000,5000000,5000000.0,5000000.0,0.0,0.0,5000000,0
0x0774769FBF597E393a288e67aF6C9F1f8BF80193,548799,2,2,0,548799,0,274399.5,0,222972.5,0,497372,548799
0x6ba7Fe01EeC4C6A4308C8E2B35970e0488ce9a86,178641096,46,32,14,89320548,89320548,2791267.125,6380039.142857143,6536940.527339804,10308115.351441316,35397548,0
0x8Cf488240aA2a231A149b0E69E6862B61ad78E01,23053404,3,2,1,11526702,11526702,5763351.0,11526702.0,3956637.0,0.0,11526702,0
0x9eCB52EB8f3d6648cD13235850A7221f57ca9623,30000000,2,1,1,15000000,15000000,15000000.0,15000000.0,0.0,0.0,15000000,0
0xA5DF8b9C6979a41d05dC1aB1a45875D57CFF70FF,15000000,2,1,1,7500000,7500000,7500000.0,7500000.0,0.0,0.0,7500000,0
0x02Fa97F7Afc4a7BB4533508b44667CDd8F91FB13,167658,1,0,1,0,167658,0,167658.0,0,0.0,167658,0
0xe7c75b1674eb491be1C4211547bAD484dee9cf08,167658,1,1,0,167658,0,167658.0,0,0.0,0,167658,167658
0xF24fC24a134392BA3FAD56685ffaD98692685FF6,24046,2,1,1,12023,12023,12023.0,12023.0,0.0,0.0,12023,0
0x0eb1665dE6473c624dcd087FdEee27418D65eD59,57318,2,2,0,57318,0,28659.0,0,16636.0,0,45295,57318
0xaB27C40e443d52ddac039D89EB89AfEeE30e0De9,2000000,1,1,0,2000000,0,2000000.0,0,0.0,0,2000000,2000000
0x8DB03959B359E756468FA75E747771810B4fc4E6,560000,4,0,4,0,560000,0,140000.0,0,207846.0969082653,500000,675281
0xb79BDFD0289B4e905c3078697887EBd66eB77780,20000,1,1,0,20000,0,20000.0,0,0.0,0,20000,20000
0x54D6Dcc2ABde0FD82D520D5A0D43D56f40B335A4,105074,2,1,1,52537,52537,52537.0,52537.0,0.0,0.0,52537,0
0x7e2F3B873fC2079A9F266967aaaF44D49abb2611,20000,1,1,0,20000,0,20000.0,0,0.0,0,20000,20000
0x0042BFbaFbd7A6B09eb1c0AdE031164490C14F4b,20000,1,1,0,20000,0,20000.0,0,0.0,0,20000,20000
0x1E9DcD315F98c9D0C0fAd71D5C884BE88fAD2cD3,1032191,10,8,2,832191,200000,104023.875,100000.0,8024.711964262331,0.0,110248,1620299
0x841cEc63ce438c4B1d7F6C6EDEFe1D3F9A113191,2002322,3,2,1,1001161,1001161,500580.5,1001161.0,490580.5,0.0,1001161,0
0x683a42E5B414Ae5cF79ece7e369cA5937fdcDC11,2022321,6,2,4,1011161,1011160,505580.5,252790.0,495580.5,193243.6413843933,1001161,1
0xee5aE59450E0a0dDb7C641E5188819244853E28a,913874,2,1,1,456937,456937,456937.0,456937.0,0.0,0.0,456937,0
0xC90fb2F730b4e31E18654ECE88Cc2a47C04a231c,90,2,1,1,89,1,89.0,1.0,0.0,0.0,89,88
0x8d88e4Bb6cF89D75831A88E68eC32C61eAdb05b6,1,1,1,0,1,0,1.0,0,0.0,0,1,1
0xbf32B32A8ca716fc9A2ecA3D4B2eC2E0CD5F531C,24000000,2,1,1,12000000,12000000,12000000.0,12000000.0,0.0,0.0,12000000,0
0x5B442FDbfA96C96a3d6cEC8df2C40d2ea9552847,233271,1,1,0,233271,0,233271.0,0,0.0,0,233271,233271
0x60e24184DB5AdEAE3f10c443040E82b5dF7773Db,2792164,3,2,1,1396082,1396082,698041.0,1396082.0,242258.0,0.0,1396082,0
0x016606Acc6B0cFE537acc221e3bf1bb44B4049Ee,11241428,10,5,5,5622390,5619038,1124478.0,1123807.6,1532517.3820569867,1533024.4985403982,4118134,14027
0xb7E5faf485EE1d509F54d09faaA8590F282423DA,5066554,2,2,0,5066554,0,2533277.0,0,1584857.0,0,4118134,9743314
0x8d8404f8Cca4c8834Ca3caB1E54887ae47724BEE,6186956,5,2,3,3093478,3093478,1546739.0,1031159.3333333334,1020646.0,489939.631047427,2567385,0
0x17CC6042605381c158D2adab487434Bde79Aa61C,4681200,521,520,1,2348584,2332616,4516.507692307692,2332616.0,9109.634555699935,0.0,2332616,15968
0x11796990156415ca014332678d9d60ba6B7508d6,1988776,2,1,1,994388,994388,994388.0,994388.0,0.0,0.0,994388,0
0xb965cefecad58B194473CA3789654b2756f6b579,284000,2,1,1,142000,142000,142000.0,142000.0,0.0,0.0,142000,0
0x80E6A99079e4407dF210e07a734D82eb3EA84Ed1,177674,2,1,1,88837,88837,88837.0,88837.0,0.0,0.0,88837,0
0x6c10dfcDC70709a3ef739E541b6AD5709723C801,887916,2,1,1,443958,443958,443958.0,443958.0,0.0,0.0,443958,0
0xb4F69500AC3789A0e9B4C180ACB1af1153e33653,4063780,2,1,1,2031890,2031890,2031890.0,2031890.0,0.0,0.0,2031890,0
0x2b5479250eF961151078F9060820A0F2042B3acb,88524,2,1,1,44262,44262,44262.0,44262.0,0.0,0.0,44262,0
0x2E806eD3059d71A14ff3b6cBD17740180A09ea95,187844,4,2,2,93922,93922,46961.0,46961.0,2609.0,2609.0,49570,0
0xB04A0314abc2F6FB3A734d29e9d6B7668E171e8a,88366,2,1,1,44183,44183,44183.0,44183.0,0.0,0.0,44183,0
0x086348A542a8809cCB0DAF0eFD5D91B6EF3FCaDa,69974,2,1,1,34987,34987,34987.0,34987.0,0.0,0.0,34987,0
0x56503C7F2DF2117CCC929A252D9E87199103B421,8834,2,1,1,4417,4417,4417.0,4417.0,0.0,0.0,4417,0
0x33D05eEF1dEC691c7006BD007f9826881D25aaaA,46632,2,1,1,23316,23316,23316.0,23316.0,0.0,0.0,23316,0
0xe0eAFf187a7E7842F061C3979F6dc0d4848F2275,706180,2,1,1,353090,353090,353090.0,353090.0,0.0,0.0,353090,0
0x9885a7604BAD3e7FBA4996Fc0aC26E9B2DD4e3DD,123526,2,1,1,61763,61763,61763.0,61763.0,0.0,0.0,61763,0
0xF9E1845cf5E982F4E13F23d75d41Bf795d35Bcf1,867510,5,3,2,433755,433755,144585.0,216877.5,33184.2535248271,55609.5,272487,0
0x09b63650564f661e58E6AbF8CD472097Dfe9218b,35262,2,1,1,17631,17631,17631.0,17631.0,0.0,0.0,17631,0
0x94c6581F429bfd84116548c48aE717cFB27D694d,198000,2,1,1,99000,99000,99000.0,99000.0,0.0,0.0,99000,0
0x12aA7ed8Fa4282b73f2521e0E80996BD39A67d5a,151290,2,1,1,75645,75645,75645.0,75645.0,0.0,0.0,75645,0
0x193b46BbA7b68054e8169Ef8990FF3d23a5f2681,17618,2,1,1,8809,8809,8809.0,8809.0,0.0,0.0,8809,0
0x46B4330B31A472b9331DAEc89281e39880720FE3,614568,8,4,4,307284,307284,76821.0,76821.0,16642.738266282984,9419.135045215138,99586,0
0x310D97397685fE0e3a193F46BFbED736fbcA9Cfa,5235966,2,1,1,2617983,2617983,2617983.0,2617983.0,0.0,0.0,2617983,0
0x26770adC0903BA5958FB3a039956F5B1D57CC214,632112,2,1,1,316056,316056,316056.0,316056.0,0.0,0.0,316056,0
0x31e9bF2A9e277878A2446A8005E0DC427b18B8a1,8345948,4,2,2,4172974,4172974,2086487.0,2086487.0,0.0,0.0,2086487,0
0x21DDf1Db140AA2855F3A1C4377EA35e4A097a1c3,8784,1,1,0,8784,0,8784.0,0,0.0,0,8784,8784
0xd50D3B91C2eD0F89f846510b0b9dc21c2d1BD7bd,107262,4,2,2,53631,53631,26815.5,26815.5,18031.5,18031.5,44847,0
0x28D17ab9c8e38AF07df9578a9b68782FBad0852B,154314,2,1,1,77157,77157,77157.0,77157.0,0.0,0.0,77157,0
0x354f773cB12907A3322Dfe084918e22a1e2bfDF6,3579860,2,1,1,1789930,1789930,1789930.0,1789930.0,0.0,0.0,1789930,0
0x88eC655F90aE4C050A05B11199bb3B29d0A85dbd,449694,13,6,7,224847,224847,37474.5,32121.0,26882.838632046776,26109.508853508305,91712,0
0x2f25FE5ec01a65E14d774b68AED9DF052DbEe8D7,4391296,2,1,1,2195648,2195648,2195648.0,2195648.0,0.0,0.0,2195648,0
0x7Ab0d3D9fe0D7C0b8c6DcfA0eb4bB3ca44f5f298,44320,2,1,1,22160,22160,22160.0,22160.0,0.0,0.0,22160,0
0x80fE9934A97e6A7F5e8c835A7A9238eE56807AAc,5407024,4,2,2,2703512,2703512,1351756.0,1351756.0,40424.0,40424.0,1392180,0
0x4bF678951313B08b33799Dc0238557b545006d57,266786,2,1,1,133786,133000,133786.0,133000.0,0.0,0.0,133786,786
0xacDf6e4FaCcc2a06347fB90F9ae8fEaFd3c4e984,35738,2,1,1,17869,17869,17869.0,17869.0,0.0,0.0,17869,0
0x46C95F0012DC6c64F632DFF428232e6242fFA28b,253126,2,1,1,126563,126563,126563.0,126563.0,0.0,0.0,126563,0
0x98d0EFF0973DAf7da70a2463A5c9854d4f4028dE,102076,2,1,1,51038,51038,51038.0,51038.0,0.0,0.0,51038,0
0x13307b8854a95946b54A904100AFd0767a7a577b,19007288,33,20,13,9503644,9503644,475182.2,731049.5384615385,195172.93752019003,365208.1491153347,1722401,0
0xf653121Cdc8042eBdaf31C8Ff675c16C8d973b0e,39508,4,2,2,19754,19754,9877.0,9877.0,942.0,942.0,10819,0
0x82Ae756688E1baE9A0957BC1c0628bdAeBcB14f7,13624,2,1,1,6812,6812,6812.0,6812.0,0.0,0.0,6812,0
0xd354DBBd8591a50B974d9Aa66af93f50Ce9b25D4,36060,2,1,1,18030,18030,18030.0,18030.0,0.0,0.0,18030,0
0x3CBD77c7d5D8f4da3B3Dd8C7F52a1A464AEE066D,108180,2,1,1,54090,54090,54090.0,54090.0,0.0,0.0,54090,0
0x17398399b6ABDC03C5b99316E692976C8F5D54f6,10818,2,1,1,5409,5409,5409.0,5409.0,0.0,0.0,5409,0
0xd2E898bfbDB0dadee09D966920282D70eF7cC55b,102748,2,1,1,51374,51374,51374.0,51374.0,0.0,0.0,51374,0
0xa007D946BaD4e53C4E57f37E7e10Bef28e5bbc5E,49794,2,1,1,24897,24897,24897.0,24897.0,0.0,0.0,24897,0
0x8A1E66Bff637a4bC3B756d1a299A98B6D26C61Cb,3309688,4,2,2,1654844,1654844,827422.0,827422.0,2017.0,2017.0,829439,0
0xace4f4a061e5487ce77b7A0397F9acD7ADA8BF4f,1318500,2,1,1,659250,659250,659250.0,659250.0,0.0,0.0,659250,0
0x6d5f8ed75edB1691F8B63791F23Ffb1288E1467a,52954171,41,20,21,26477086,26477085,1323854.3,1260813.5714285714,347403.0167526039,405255.27795741305,1702365,1
0xB52C437A418E635Fc5C99102C1C1883257a36596,21546,2,1,1,10773,10773,10773.0,10773.0,0.0,0.0,10773,0
0x169b009B0fA5C0a44134159392b3dD1239Aa3E6d,190744,2,1,1,95372,95372,95372.0,95372.0,0.0,0.0,95372,0
0xd9300468bDefF5A209d17aa3f1f8ee2993526Dbd,39927,3,3,0,39927,0,13309.0,0,3320.0268071206897,0,15827,39927
0xCbFDf83325BB05FE376Ed80F0D6b092e8316c06b,179960,2,1,1,89980,89980,89980.0,89980.0,0.0,0.0,89980,0
0x9a22C60447083c99a238054b3c722eF1F2c6F23f,150674,5,2,3,75337,75337,37668.5,25112.333333333332,11824.5,3439.434288109343,49493,0
0x346DD6AF4c1a74B66D50A725e62e94931218dd53,187664,2,1,1,93832,93832,93832.0,93832.0,0.0,0.0,93832,0
0x121e9da048d70e70CaA07Bf7c7548BCcE906835a,35854,4,2,2,17927,17927,8963.5,8963.5,53.5,53.5,9017,0
0x01124B458BD46fc1EbDFBe8592408Ca2ABbb4262,464050,6,3,3,232025,232025,77341.66666666667,77341.66666666667,14241.364549165302,14241.364549165302,97478,0
0x07CCDa00d82146737134DCe50EC99753e57BfB78,17936,2,1,1,8968,8968,8968.0,8968.0,0.0,0.0,8968,0
0x1Ea55A8F5bA92a35DA7AAFc86290309FE7F10005,1190916,4,2,2,595458,595458,297729.0,297729.0,28511.0,28511.0,326240,0
0xfE74F40ac5DFb884B49fA2C86089CeCbf5b76237,337352,4,2,2,168676,168676,84338.0,84338.0,32254.0,32254.0,116592,0
0x0D0c5bE4342137037B20284dc0D3816567a536F7,1937746,7,3,4,968873,968873,322957.6666666667,242218.25,96867.98692493247,145251.62780219538,451357,0
0x38c921d0e1FCB843C6d2376B5ebdE965bB523b86,447868,2,1,1,223934,223934,223934.0,223934.0,0.0,0.0,223934,0
0x221E670394bb2DCb64bC4A8D0fc1b13218e75884,12362,2,1,1,6181,6181,6181.0,6181.0,0.0,0.0,6181,0
0x829A75f2Eb02A8fCee2F116eC03f53fdF79E657e,37876,2,1,1,18938,18938,18938.0,18938.0,0.0,0.0,18938,0
0x3E3e7d1C8CfF97C3fA31e0630cB7421D4D0b5f76,491869,7,3,4,246395,245474,82131.66666666667,61368.5,17697.115289096004,26132.127290942084,100394,921
0xbE4CCDD656C7B4953cfe4B3d2C3C0830DCC74560,94544,4,2,2,47272,47272,23636.0,23636.0,3270.0,3270.0,26906,0
0x123E68b0Cffaca39A1f352DE1C3776Dd7987cB67,178430,2,1,1,89215,89215,89215.0,89215.0,0.0,0.0,89215,0
0xb95593308eBf17F6A63C1ADdF3C75bF9E5B300B4,65856,3,2,1,32928,32928,16464.0,32928.0,872.0,0.0,32928,0
0xD3e6c181086dea59e28E88335eC8c1114536D280,794156,2,1,1,397078,397078,397078.0,397078.0,0.0,0.0,397078,0
0xbD62A612F1340111B861A038941efF0ccB4F12AA,161608,2,1,1,80804,80804,80804.0,80804.0,0.0,0.0,80804,0
0x0E5C7DFfD5CDed71B43B0fb5971ddB7e26766f14,397914,8,4,4,198957,198957,49739.25,49739.25,2090.585847914407,2090.585847914407,52875,0
0x9e391e16ebAEc58069A94a99860b6c56c63A7898,39116,3,2,1,19558,19558,9779.0,19558.0,1023.0,0.0,19558,0
0xAc29C60b1876068DAba2DA7f6dA933A65648f451,759754,10,5,5,379877,379877,75975.4,75975.4,31332.138424308036,31332.138424308036,106631,0
0x11aE298E74A77ec562A5Ff262eE0586568eb03c5,431940,2,1,1,215970,215970,215970.0,215970.0,0.0,0.0,215970,0
0xf85de0B2322dEaA26BFFf0245dDBF99c71F9E748,128194,2,1,1,64097,64097,64097.0,64097.0,0.0,0.0,64097,0
0xefA7Ff0d382CBDEa2Ff60dE3b3831F836Eb9C624,6329752,2,1,1,3164876,3164876,3164876.0,3164876.0,0.0,0.0,3164876,0
0xdCc06F15f4099f112B62fA9345B2FeecA1cb9D51,89976,2,1,1,44988,44988,44988.0,44988.0,0.0,0.0,44988,0
0xE67eEdf10C5EB6b61D0f3A6E1ddEc15b5211a8Ca,359744,2,1,1,179872,179872,179872.0,179872.0,0.0,0.0,179872,0
0xbE0CEBc57835156Be90ACA2a3Fa14B221f55C0c1,17980,2,1,1,8990,8990,8990.0,8990.0,0.0,0.0,8990,0
0xB21822Da2b1B182B37C1d415d5fc2b1a979D3402,2856864,6,3,3,1428432,1428432,476144.0,476144.0,289157.8320122075,289157.8320122075,683193,0
0xF0D6D3E44314De9ca7F2666EA4F75deFD117bdd2,199876,2,1,1,99938,99938,99938.0,99938.0,0.0,0.0,99938,0
0xa6dfa59C68D74e8D8FFccFa717619013223e0Cd6,199876,2,1,1,99938,99938,99938.0,99938.0,0.0,0.0,99938,0
0x1b9022AA90B30D137A0C049A1D27E594B46cf8Be,8986,1,1,0,8986,0,8986.0,0,0.0,0,8986,8986
0xdb5019b8DfbccEF8906C39B16a4870082eAbBc4C,354916,4,2,2,177458,177458,88729.0,88729.0,1148.0,1148.0,89877,0
0x644A374620A088445820aE76b20B8Bb542BfCE72,41694,2,1,1,20894,20800,20894.0,20800.0,0.0,0.0,20894,94
0xe10C71796a367dc7355FF2F2910BCB8205245F9c,409850,4,2,2,204925,204925,102462.5,102462.5,40072.5,40072.5,142535,0
0x602b985063400954F66768c090F3C82a4ee1d9aE,101092,2,1,1,50546,50546,50546.0,50546.0,0.0,0.0,50546,0
0xC29fAa1BEBa9862e8b7f00492520A3e26a244572,107754,2,1,1,53877,53877,53877.0,53877.0,0.0,0.0,53877,0
0x8e5a3B0cDB7C3157CB3d257DAC328482bE298367,359154,4,2,2,179577,179577,89788.5,89788.5,0.5,0.5,89789,0
0x6232afA76050C679406c165CaC98F665c401b4b3,384574,8,4,4,192287,192287,48071.75,48071.75,3581.00198094053,3581.00198094053,52846,0
0x0131bfc836e2cb4c5A2B6f0A219620D0C34810E6,2560196,2,1,1,1280098,1280098,1280098.0,1280098.0,0.0,0.0,1280098,0
0x63C604379428b4c34F95933ED51D5f769C8079Cf,5276,2,1,1,2676,2600,2676.0,2600.0,0.0,0.0,2676,76
0x80d3988f600a0FD28454A9386D137F9CeBB54A1F,2705078,4,2,2,1352539,1352539,676269.5,676269.5,20884.5,20884.5,697154,0
0xf8Ac72F1422B680a4B5Bb69E472601f9b8be7a53,801926,2,1,1,400963,400963,400963.0,400963.0,0.0,0.0,400963,0
0x2DcfCcb66F0eE8EbAb6E33Ec977355f2415bb80b,3687092,6,3,3,1843546,1843546,614515.3333333334,614515.3333333334,271288.86782091804,271288.86782091804,990000,0
0x53ED39Da6eaafe31bd3d817661eD9356aE959893,2012922,3,2,1,1006461,1006461,503230.5,1006461.0,315767.5,0.0,1006461,0
0xdC6495104Be685e3ECAE8AdcA487f59869E4a822,60520,2,1,1,30260,30260,30260.0,30260.0,0.0,0.0,30260,0
0x665d14165bd1611777c037cc6560E7F22C37F54F,8035,1,1,0,8035,0,8035.0,0,0.0,0,8035,8035
0xD3e6157f164357df0ec41c5B6A91282581053653,157238,4,2,2,78619,78619,39309.5,39309.5,14254.5,14254.5,53564,0
0x9d3C3e50434e135eaa8f344F2975083E2EE56307,25802,2,1,1,12901,12901,12901.0,12901.0,0.0,0.0,12901,0
0x51eBEf5b2eCA862cC26C402E65058642a03696bA,64848,2,1,1,32424,32424,32424.0,32424.0,0.0,0.0,32424,0
0x3A6e0DF93d9377f6224C68bFA6053230389E2f92,232012,2,1,1,116006,116006,116006.0,116006.0,0.0,0.0,116006,0
0x6517D689D4D4dd8C2e4ABD79b2c7C07C1BABF672,713192,2,1,1,356596,356596,356596.0,356596.0,0.0,0.0,356596,0
0x26ADcf5EB1FB4f87202Ac772c009f02D51c89e1b,890228,2,1,1,445114,445114,445114.0,445114.0,0.0,0.0,445114,0
0x562F0dAeAA5aA30D8954c5C31DD1EE3C6F17d978,71148,2,1,1,35574,35574,35574.0,35574.0,0.0,0.0,35574,0
0x8361A8bC4B4fC93Ea9118F6d42B7Fe85de5f67ae,198000,2,1,1,99000,99000,99000.0,99000.0,0.0,0.0,99000,0
0x119f079871594e9FFc22D9453785C9E9364F2bCe,44160,4,2,2,22080,22080,11040.0,11040.0,15.0,15.0,11055,0
0xF0d21D9475B047e12FA710659a65E85cd31ADd57,35376,2,1,1,17688,17688,17688.0,17688.0,0.0,0.0,17688,0
0x876facDf2e8F42906D0e6187F33fCCF115F6BcAf,53168,2,1,1,26584,26584,26584.0,26584.0,0.0,0.0,26584,0
0xEdad9102B4b80C54A25739B50d920791DBf6A9E0,5409,1,1,0,5409,0,5409.0,0,0.0,0,5409,5409
0x0D869a936f7faF615E584DbA700951b5972d5FB3,53354,2,1,1,26677,26677,26677.0,26677.0,0.0,0.0,26677,0
0x00CE3c8E27f3aBC7bFaD8Cf87929b3b4dddd49Bf,53332,2,1,1,26666,26666,26666.0,26666.0,0.0,0.0,26666,0
0x8E066f69ce11AEAE7b796a399ccEdeE14291D0b2,53326,2,1,1,26663,26663,26663.0,26663.0,0.0,0.0,26663,0
0x6Eca4Cb3Cd9AF1A7961e3C04c6E121d79bDeA580,98982,2,1,1,49491,49491,49491.0,49491.0,0.0,0.0,49491,0
0x74A773d82E84565dcBbe1F2b554baa5B2f21f26E,837618,3,1,2,418809,418809,418809.0,209404.5,0.0,59404.5,418809,0
0xac1Eb7459AF366444CC502d9b002E2eEf577C02E,35182,2,1,1,17591,17591,17591.0,17591.0,0.0,0.0,17591,0
0x41773918424aF862960C5a90f5bEC7B2F4b3A284,177486,2,1,1,88743,88743,88743.0,88743.0,0.0,0.0,88743,0
0xfeB4DC9905Ebf2b070509C8313c939a4D15a015B,177486,2,1,1,88743,88743,88743.0,88743.0,0.0,0.0,88743,0
0x03B0f3107189e48BbeC1f50a312dF3BcCD318f9b,158400,2,1,1,79200,79200,79200.0,79200.0,0.0,0.0,79200,0
0x7Bd90Cac2818D48c6A717FB658D173a75557A2D7,216450,2,1,1,108225,108225,108225.0,108225.0,0.0,0.0,108225,0
0x5D844d7DeE840D08FB1fEb4C3590E0D05B0b1916,62102,2,1,1,31051,31051,31051.0,31051.0,0.0,0.0,31051,0
0x70B3B6d7c4489cc014792B6CD9d8E0DA0fd1746c,176022,2,1,1,88011,88011,88011.0,88011.0,0.0,0.0,88011,0
0x1B580Fa764289b2992534dbdbB5914b47bEf51d9,71908,2,1,1,35954,35954,35954.0,35954.0,0.0,0.0,35954,0
0xF8ce8bB0B1f3d640711b10148d0251d840c45805,3929542,2,1,1,1964771,1964771,1964771.0,1964771.0,0.0,0.0,1964771,0
0x2FDccE22db6A39cFA68C6dabC417ff2C295711AB,500474,8,4,4,250237,250237,62559.25,62559.25,9413.689403602606,9413.689403602606,75804,0
0x9cF7c252Fc4cF77d00562ae93185E66322884Fa9,299648,2,1,1,149824,149824,149824.0,149824.0,0.0,0.0,149824,0
0x119D066b1fdc0867CbE92dbeAB1F601065C24A62,11462,2,1,1,5731,5731,5731.0,5731.0,0.0,0.0,5731,0
0xDD6cf1796674C228E2B6b8439352F40f955C00Fe,130454,2,1,1,65227,65227,65227.0,65227.0,0.0,0.0,65227,0
0xDc2DB9a714a2615699C743C20812644B7766A743,2774070,3,2,1,1387035,1387035,693517.5,1387035.0,201177.5,0.0,1387035,0
0xE0e8C1D735698060477e79a8e4C20276Fc2Ec7A7,149538,2,1,1,74769,74769,74769.0,74769.0,0.0,0.0,74769,0
0xF60C581E9299d7731dd46A6C93bEa04Fddc8E0D3,216468,10,9,1,108234,108234,12026.0,108234.0,6517.664544229867,0.0,108234,0
0x4eF3E721607c4988aE3B6489834c1d9D818C888B,33448,2,1,1,16724,16724,16724.0,16724.0,0.0,0.0,16724,0
0x8b35569f7038028BB50194a1009cc8c7eea579DC,221688,4,2,2,110844,110844,55422.0,55422.0,7976.0,7976.0,63398,0
0x14E5C150A0D9334aba3a848912577d2AEcFca658,228948,5,3,2,114474,114474,38158.0,57237.0,8296.483954061503,5712.0,62949,0
0x1206a7dEd1503C00C71D90C9CFe5c2d0DBAD8168,37152,2,1,1,18576,18576,18576.0,18576.0,0.0,0.0,18576,0
0xd94Ca8bfeB5984b85cd8dD20197315aC0d2eDDdD,15035822,4,2,2,7517911,7517911,3758955.5,3758955.5,36842.5,36842.5,3795798,0
0x2E822887361d618aD80A4FbE24DA7D8521F712C2,534836,3,2,1,267418,267418,133709.0,267418.0,69347.0,0.0,267418,0
0x2C47fc85E59624C967619C0eB6d976Fc44e46cFA,758202,2,1,1,379101,379101,379101.0,379101.0,0.0,0.0,379101,0
0xD0df707aD6734a103364e5E75dAa40fC2c870b54,17854,2,1,1,8927,8927,8927.0,8927.0,0.0,0.0,8927,0
0x52B60FeFDFfc9946D307a6bd92F5E529311d2A9D,1929318,2,1,1,964659,964659,964659.0,964659.0,0.0,0.0,964659,0
0x9796cB849b3abF26A41167afae3A8DC6a40166be,12603068,78,37,41,6301534,6301534,170311.72972972973,153695.9512195122,120663.20837291653,117553.62812775125,751031,0
0x1EA19c18eB629F94362303a8C15F79469A546d06,174936,2,1,1,87468,87468,87468.0,87468.0,0.0,0.0,87468,0
0x14a8bD121EbfB116Bcf296fF07e92aa41c728598,401952,2,1,1,200976,200976,200976.0,200976.0,0.0,0.0,200976,0
0xF876fEBf84e3c257E58a9DA2093E0515501Eab5A,260092,2,1,1,130046,130046,130046.0,130046.0,0.0,0.0,130046,0
0x191EE2BcBAdD7aF9b9F280C0C00bEdDa6Fc2D8d4,158516,2,1,1,79258,79258,79258.0,79258.0,0.0,0.0,79258,0
0xE52B189427c4889914EC04857E8F2D06A9Ecca7C,20311,2,1,1,10311,10000,10311.0,10000.0,0.0,0.0,10311,311
0x1408B6c99144Fe11E979e60741a34bb690935585,104780,2,1,1,52390,52390,52390.0,52390.0,0.0,0.0,52390,0
0x881e35a5700f049A54112823Bc2bA6eFA8219A8F,24600,3,1,2,12300,12300,12300.0,6150.0,0.0,2150.0,12300,0
0x30E005b05Eea4aCB0b54C89a521014a6e84fF908,5705402,4,2,2,2852701,2852701,1426350.5,1426350.5,531546.5,531546.5,1957897,0
0x9Ac944ADa45531304ab9ADab06C5cf575E35A203,51626,2,1,1,25813,25813,25813.0,25813.0,0.0,0.0,25813,0
0x23383f5cf162A74f120473867DF5Dd13E1e16b04,423156,6,3,3,211578,211578,70526.0,70526.0,13071.63195626315,13071.63195626315,88997,0
0xe2350E83B43b42bEdFc65d872618ECD6b2B3e9B6,53495,2,1,1,26795,26700,26795.0,26700.0,0.0,0.0,26795,95
0xEbad88ea8c1dEA07f6591f37D0c57E3f3d701D42,1175818,2,1,1,587909,587909,587909.0,587909.0,0.0,0.0,587909,0
0xF077084D75e8027a3786eF3C130D9834C285e391,4645972,4,2,2,2322986,2322986,1161493.0,1161493.0,171493.0,171493.0,1332986,0
0xDE13Bd58b5c57d9E56b6d29451f075BB5873273d,1592638,2,1,1,796319,796319,796319.0,796319.0,0.0,0.0,796319,0
0x2561fb84FAd0ec99b36E806311AfB3167D466A89,129654,2,1,1,64827,64827,64827.0,64827.0,0.0,0.0,64827,0
0xBB1A50508Ce5d222269184A04E7705b8DFa8D20b,120915130,53,29,24,60457565,60457565,2084743.6206896552,2519065.2083333335,1748389.3839521504,1846580.5661573496,5128017,0
0x51ecDC62FeA43E8596F82EBbE288FED29f909634,2188338,6,3,3,1094169,1094169,364723.0,364723.0,119789.04359748433,119789.04359748433,449698,0
0xdC37aA84203ca1EFed8823c813f69371ad0dB513,1242488,2,1,1,621244,621244,621244.0,621244.0,0.0,0.0,621244,0
0x2a9d1477ED931F31C9506aa8c3d478B9a3ce67e3,76438,2,1,1,38219,38219,38219.0,38219.0,0.0,0.0,38219,0
0x59f386D713260a514205eBe42883Ae630d8D6FB2,101332,2,1,1,50666,50666,50666.0,50666.0,0.0,0.0,50666,0
0x20aCa469c6Fb6F2607370010b38Ca680b09B4dFc,67710,2,1,1,33855,33855,33855.0,33855.0,0.0,0.0,33855,0
0x9B2676ee663e222D0d5dDFb51fA5FbDf3acFb681,27252,2,1,1,13631,13621,13631.0,13621.0,0.0,0.0,13631,10
0x432674F1eC183B78E20Af63216f426876d5312f5,98036,2,1,1,49018,49018,49018.0,49018.0,0.0,0.0,49018,0
0x26dD4199269bec9457F84ADb029dB917A910c711,497454,2,1,1,248727,248727,248727.0,248727.0,0.0,0.0,248727,0
0x7EeCa051C3F086B16eE743094aF9b245Cf5D0082,501296,2,1,1,250648,250648,250648.0,250648.0,0.0,0.0,250648,0
0x5fD7388fAdEaaD6B097D598133b3222528136Ea6,6355889,2,1,1,3153965,3201924,3153965.0,3201924.0,0.0,0.0,3201924,0
0x1F082886fD50F11e4181BF5D829B3829314EFae5,5599850,6,3,3,2799925,2799925,933308.3333333334,933308.3333333334,20655.592403887997,20655.592403887997,957022,0
0x0AD5272620317BF7068A2a0f775F1E15ef130373,482036,2,1,1,241018,241018,241018.0,241018.0,0.0,0.0,241018,0
0x41885e0ff1ad88FC45B37239e25b122cEbeC4336,1569590,8,5,3,784795,784795,156959.0,261598.33333333334,112752.25867538087,27854.55089488171,377989,0
0xf0a8BA6d39580930dE67c803c5FE6C4D71266290,123536,2,1,1,61768,61768,61768.0,61768.0,0.0,0.0,61768,0
0x58D224632C662C0677422EfBd69616940C4251a6,8912,2,1,1,4456,4456,4456.0,4456.0,0.0,0.0,4456,0
0x8F9E303556C0309Fe5C2ffbF92EF072d8fC97474,2673,1,1,0,2673,0,2673.0,0,0.0,0,2673,2673
0xAebE694b1fE3F50d742109825B636098d2637E43,888960,2,1,1,444480,444480,444480.0,444480.0,0.0,0.0,444480,0
0x40b50d0ae03B46e5f745A227398c5F714f496aB8,976934,2,1,1,488467,488467,488467.0,488467.0,0.0,0.0,488467,0
0x008E1628ABac5bc6dc7fA47fAEe67ba682326012,137127,4,2,2,72049,65078,36024.5,32539.0,9053.5,12539.0,45078,6971
0x418c8A7A1B45A1a0C5D891dB76a32Ba0b5A7B869,128194,2,1,1,64097,64097,64097.0,64097.0,0.0,0.0,64097,0
0xcfFB818AE9F32a183196FfE402358B03B68C56de,63059127,25,13,12,31529564,31529563,2425351.076923077,2627463.5833333335,1765477.1731580307,1227652.144764649,4674028,1
0xf7ACA882f5863c3eBA79F12CdFDbe19eF1779D8c,21323933,10,7,3,10727974,10595959,1532567.7142857143,3531986.3333333335,1677756.0084149572,1652660.1615493193,5137253,132015
0xF2B21A376933a6Ae89ffEdc9BAf8d79E0325A1Ab,237388,2,1,1,118694,118694,118694.0,118694.0,0.0,0.0,118694,0
0x5cBACCEDE828d0350FFf1f6DE9f7EB0Fb6DEa76A,983600,1,1,0,983600,0,983600.0,0,0.0,0,983600,983600
0xBe83E7Db6C6fb4F5DB4F22294FAF3868Ca443F2B,14083170,25,18,7,7190265,6892905,399459.1666666667,984700.7142857143,225111.72598222073,345780.50199128775,1566310,297360
0x5ef90fE4f7140ABc85FB21197BDE2E6f50E45aa6,89416,2,1,1,44708,44708,44708.0,44708.0,0.0,0.0,44708,0
0x99229dE5ae143E1Ba0b058b90f2b3e7Af952236B,336904,2,1,1,168452,168452,168452.0,168452.0,0.0,0.0,168452,0
0xd147C61ff65814ECFde7b3a2c93F63B41e7Ecb5e,1299622,2,1,1,649811,649811,649811.0,649811.0,0.0,0.0,649811,0
0xCeAAeF7233F85d74B93dc47438a771D16A72Db7C,72186,2,1,1,36093,36093,36093.0,36093.0,0.0,0.0,36093,0
0x74b2871b730620e2757c21FeE5848Da1CD088929,351226,2,1,1,175613,175613,175613.0,175613.0,0.0,0.0,175613,0
0x4b5264aACef9b87C2abA5e9510fDF36587E108D5,20092172,12,6,6,10046086,10046086,1674347.6666666667,1674347.6666666667,477081.60940090276,475972.698417205,2029269,0
0x1A6353F8e9a60b35df860b3f639FD816902A78Cc,4006378,4,2,2,2003189,2003189,1001594.5,1001594.5,1594.5,1594.5,1003189,0
0xd08e3d8bddEE89c5aa077DfF731959fd19ccBe85,50284,2,1,1,25142,25142,25142.0,25142.0,0.0,0.0,25142,0
0xd48c12aEEF295079E9665EBa26f6456178321B40,238642,3,1,2,119321,119321,119321.0,59660.5,0.0,42952.5,119321,0
0x06e494FA63f4DF90898b5F26e1e1514B9B30343a,9373994,2,1,1,4686997,4686997,4686997.0,4686997.0,0.0,0.0,4686997,0
0x7595787bc6F60499EFEc6484D1114c56Dec2EB70,1782162,2,1,1,891081,891081,891081.0,891081.0,0.0,0.0,891081,0
0xACb37D20479dB0587E3C1a469A1b25F2450AB250,713510,2,1,1,356755,356755,356755.0,356755.0,0.0,0.0,356755,0
0x589AE443B1a5ceE74444677457ED5C4cf53e9c63,730414,2,1,1,365207,365207,365207.0,365207.0,0.0,0.0,365207,0
0x7D12Bbd4c48459be6750282AfaEC91338FC4e85c,608150,9,4,5,304075,304075,76018.75,60815.0,32006.268990425924,25676.00163576876,104244,0
0x8f6aaD008Bc82BD2f14bF6fBD870A510a8ef45D3,3063594,4,2,2,1531797,1531797,765898.5,765898.5,740936.5,495898.5,1506835,0
0xa91F80380D9Cc9c86EB98D2965A0DED9E2000791,66768596,65,30,35,33384306,33384290,1112810.2,953836.8571428572,2617488.884401286,1355940.5620200771,14600895,20
0xa8540Ff6A74cd07402cA81CE7d21Ac3A834F357b,9390732,6,3,3,4695366,4695366,1565122.0,1565122.0,524271.9027305074,524271.9027305074,1995470,0
0xc6feCDF760Af24095cDEd954dE7d81aB49f8Bae1,41721508,20,11,9,20860754,20860754,1896432.1818181819,2317861.5555555555,2185317.027758249,2616072.4690361954,8151975,0
0x1B47A1598c3fc8f3f4bc75b2BAae9dC810391Ce4,1236,2,1,1,618,618,618.0,618.0,0.0,0.0,618,0
0x39439c36716Ca5316D241943372E58230577950B,1742064,2,1,1,871032,871032,871032.0,871032.0,0.0,0.0,871032,0
0x1F65b1d3E864390b3A0Abe3061Ba21C2b73b196d,700790,4,2,2,350395,350395,175197.5,175197.5,43786.5,43786.5,218984,0
0xF7739Ac4c946056A6E302b6Db83bC0345d1DF37f,36872,2,1,1,18436,18436,18436.0,18436.0,0.0,0.0,18436,0
0x46499026e4E799b95647D3583F485E3915D5e0A8,70108,2,1,1,35054,35054,35054.0,35054.0,0.0,0.0,35054,0
0xE70A2105CBbeDDc8C3B0FD3be407915dCE9D26c3,2706654,2,1,1,1353327,1353327,1353327.0,1353327.0,0.0,0.0,1353327,0
0x1aC834dc22862822ffCbc691c93b71C71B402DEF,1572940,2,1,1,786470,786470,786470.0,786470.0,0.0,0.0,786470,0
0x6e7235e617bD8014b1B548E2e14Ad1ca116Cb429,348966,3,1,2,174483,174483,174483.0,87241.5,0.0,12758.5,174483,0
0x4000b8d6991d61167BBE3744EE15A949c047FB8f,94708,2,1,1,47354,47354,47354.0,47354.0,0.0,0.0,47354,0
0x90C5c1e13fC4f036d8f9572e1264EDcB9feFFe6c,1446286,6,3,3,723143,723143,241047.66666666666,241047.66666666666,51504.501591824206,47016.85177560157,309325,0
0x39aEfE611A8613C7adeA532562bD8664eE11865B,174322,2,1,1,87161,87161,87161.0,87161.0,0.0,0.0,87161,0
0x3e21270c7a4aE8714263c6a8054fdC7F16fD1Eda,104544,2,1,1,52272,52272,52272.0,52272.0,0.0,0.0,52272,0
0x481fE4b0A413ddaC0e0e19f1a7C416fe28AF670e,156740,2,1,1,78370,78370,78370.0,78370.0,0.0,0.0,78370,0
0x0354f4CF8b24c7471473Db559d3bC81D94738042,578130,2,1,1,289065,289065,289065.0,289065.0,0.0,0.0,289065,0
0x6B6E2b654F48d78b17e3a6fd2b627d90f166608A,1248764,4,2,2,624382,624382,312191.0,312191.0,268444.0,12191.0,580635,0
0x40fabDCDe60d98F80033D79D4d5C771Dbe0fAafa,43678,2,1,1,21839,21839,21839.0,21839.0,0.0,0.0,21839,0
0x5BB2406C109094e419aD74339A8DC388e63c93c6,774680,1,0,1,0,774680,0,774680.0,0,0.0,774680,0
0x5E62E7fe1A1b06e12C56AAcbfA9Ae3D321D57744,503400000,3,1,2,251700000,251700000,251700000.0,125850000.0,0.0,125849000.0,251700000,0
0xEbE21d0a3c99143a43f8Fb13daCA9F6cA0123899,2577569,5,3,2,1110000,1467569,370000.0,733784.5,61644.14002968976,86215.5,820000,290000
0x6b34d2ec944C210e3F11A8A6a44463CA72ABeb0c,369765,1,0,1,0,369765,0,369765.0,0,0.0,369765,0
0xBA791F9Ad33BE976D23007524CeBfe7d9eb85E86,5049,1,1,0,5049,0,5049.0,0,0.0,0,5049,5049
0xC960338B529e0353F570f62093Fd362B8FB55f0B,350544,4,2,2,175272,175272,87636.0,87636.0,66.0,66.0,87702,0
0x61343D955f34709fc29F2d7F5D6A78D68eea120E,4457912,2,1,1,2228956,2228956,2228956.0,2228956.0,0.0,0.0,2228956,0
0xF70619A78272f6b9255608799A08193B97F837a6,174222,2,1,1,87111,87111,87111.0,87111.0,0.0,0.0,87111,0
0x601E7A62481538FA974A8E983208553D2bE18a78,494382,2,1,1,247191,247191,247191.0,247191.0,0.0,0.0,247191,0
0x7832534214b5D679b4CcFA17B4f640cc0090d24b,277646,2,1,1,138823,138823,138823.0,138823.0,0.0,0.0,138823,0
0x1Bf651a3DffeDed866AF309ee307dE78235A0728,12544,1,1,0,12544,0,12544.0,0,0.0,0,12544,12544
0x36E058332aE39efaD2315776B9c844E30d07388B,452314,2,1,1,226157,226157,226157.0,226157.0,0.0,0.0,226157,0
0x5d0d5AAD7ee4949aCFc095FbFe2F2DB3B5b4f630,2489,1,1,0,2489,0,2489.0,0,0.0,0,2489,2489
0x524F912C655f8070A98bdCC2B031800b53ef91b7,1260792,2,1,1,630396,630396,630396.0,630396.0,0.0,0.0,630396,0
0x0C88C914d3576D65f891CA04247030473daCE02A,1276908,3,1,2,638454,638454,638454.0,319227.0,0.0,180773.0,638454,0
0xd8281f2B00B0Dc123FB92a84D18afd8edD64b22E,93930,2,1,1,46965,46965,46965.0,46965.0,0.0,0.0,46965,0
0x5Dc78044418aB23C9b744dFAcbebD6eD0f5Bf4a4,226414,2,1,1,113207,113207,113207.0,113207.0,0.0,0.0,113207,0
0x77D20F43B5aeB69a533E2E8A64020491D3e3d198,2009964,2,1,1,1004982,1004982,1004982.0,1004982.0,0.0,0.0,1004982,0
0xeD35AC9E77f0d52d3677Cf5B54E070b9Fa71f953,342318,2,1,1,171159,171159,171159.0,171159.0,0.0,0.0,171159,0
0x147C945e80A519242380C5d2d8F287b3e46522d3,432212,2,1,1,216106,216106,216106.0,216106.0,0.0,0.0,216106,0
0xb7394FE722D0D4fC6BB2C116030Dcf823A2761F3,3547098,2,1,1,1773549,1773549,1773549.0,1773549.0,0.0,0.0,1773549,0
0x5461Cde067Cf7d5e05973F09865732B01A4c0D44,1039948,2,1,1,519974,519974,519974.0,519974.0,0.0,0.0,519974,0
0x4ebf89c971B99BBf6CDa79825602897d387D1cE2,69478,2,1,1,34739,34739,34739.0,34739.0,0.0,0.0,34739,0
0xFdFb21FA1102Eb7Fa8E37d473cCaA4cE807C5EBC,260588,2,1,1,130294,130294,130294.0,130294.0,0.0,0.0,130294,0
0x9Ce3Ba852Cb8527342fDF6f33d65bFfe0BB65415,234538,2,1,1,117269,117269,117269.0,117269.0,0.0,0.0,117269,0
0x000000000c1500D6cf5A65167F131A53c82C1033,5606972,2,1,1,2803486,2803486,2803486.0,2803486.0,0.0,0.0,2803486,0
0x6602C14106Dd52106C5b71919720A7117BC7a8C5,7702202,3,1,2,3852202,3850000,3852202.0,1925000.0,0.0,1855000.0,3852202,2202
0x713A89041e2b28d6539D49966Ea908458a7d841d,33372,2,1,1,16686,16686,16686.0,16686.0,0.0,0.0,16686,0
0xc2cf55b33082eeaAa85f58b7bB71DdfF89a51ed5,355118,2,1,1,177559,177559,177559.0,177559.0,0.0,0.0,177559,0
0x37aD8e7D6A8Ef396fFff9Ce173D3C22bB29dca01,70200,2,1,1,35100,35100,35100.0,35100.0,0.0,0.0,35100,0
0x0c7bdA7282B86C0F5f99B6Cde8a1b2237B53b47F,38934,2,1,1,19467,19467,19467.0,19467.0,0.0,0.0,19467,0
0xBEeF44EA2f3009dB6d702214Abf5307aB976e343,289748,2,1,1,144874,144874,144874.0,144874.0,0.0,0.0,144874,0
0xA414B9308F399D1aA83eBD3b0aBa615E21DA2097,1056356,2,1,1,528178,528178,528178.0,528178.0,0.0,0.0,528178,0
0x27827023888B0B8CC48DE26F2410B567BA942Efb,11718,2,1,1,5859,5859,5859.0,5859.0,0.0,0.0,5859,0
0x2668951C5AbDfa80c6137114E157a9DDe87BaDE6,467604,2,1,1,233802,233802,233802.0,233802.0,0.0,0.0,233802,0
0xAF0EB1645BF38B86C4d73962d33F5e34399c3895,113862,3,1,2,56931,56931,56931.0,28465.5,0.0,3534.5,56931,0
0x44174180204708439CE8911D2909a0B419670fe0,262588,2,1,1,131294,131294,131294.0,131294.0,0.0,0.0,131294,0
0xC700a6AD0cd64de2Fb23e13812B8C0B578c6BF02,1745526,2,1,1,872763,872763,872763.0,872763.0,0.0,0.0,872763,0
0x1D4C3b9F8F49D6Ac44e398F766F520a3CDB0f3D5,114488,2,1,1,57244,57244,57244.0,57244.0,0.0,0.0,57244,0
0x9F7e9049d56bCC37741E0c141A62Aa1daa2E1b15,228290,2,1,1,114145,114145,114145.0,114145.0,0.0,0.0,114145,0
0xcBe824551df94889bc0a4F8Ba1783B4493C93C84,208932,1,0,1,0,208932,0,208932.0,0,0.0,208932,200424
0x906FfC08667E57450F061Ddf889e0fb24E22eB06,588796,4,2,2,294398,294398,147199.0,147199.0,42031.0,42031.0,189230,0
0x501956acE74EDb360C56d0c0Fa74B0066Fd6f486,1835148,2,1,1,917574,917574,917574.0,917574.0,0.0,0.0,917574,0
0x567b90f410ec7B3447482471a991e013b6BF6931,959158,2,1,1,479579,479579,479579.0,479579.0,0.0,0.0,479579,0
0x53390B37bf3Cd800C974eA34B5cDD2FF5CB3CFB3,98780,2,1,1,49390,49390,49390.0,49390.0,0.0,0.0,49390,0
0x044194E30e81475b5Bd42cA362e3217D1e9aF2bF,228400,2,1,1,114200,114200,114200.0,114200.0,0.0,0.0,114200,0
0xa4e7ADa85A73676f2f25a56fB7565c9070CaFEf2,228400,2,1,1,114200,114200,114200.0,114200.0,0.0,0.0,114200,0
0x14795fDF461D16D9feE500c79958104e2d5cb4c7,15876,2,1,1,7938,7938,7938.0,7938.0,0.0,0.0,7938,0
0xB1CCca89d86e990f0B52918886db0a3148389255,211664,4,2,2,105832,105832,52916.0,52916.0,0.0,0.0,52916,0
0xd0ddbFBbEDEEC5ceF630460aB54fDBCBcdd5Ae39,105842,4,2,2,52921,52921,26460.5,26460.5,0.5,0.5,26461,0
0x25d0D6aCd7d4d71d5B31dd1F9E05C8C04aBDBC38,105870,4,2,2,52935,52935,26467.5,26467.5,0.5,0.5,26468,0
0x0235f8ca04b4F875Cd40Ed02c5115878aC836255,22940,2,1,1,11470,11470,11470.0,11470.0,0.0,0.0,11470,0
0x5eb838cFC0C90602de1eeF6A6915a52824004b70,26466,2,1,1,13233,13233,13233.0,13233.0,0.0,0.0,13233,0
0xf56d32Cca096e704D740552429FFDFd4713b3E03,2562120,2,1,1,1281060,1281060,1281060.0,1281060.0,0.0,0.0,1281060,0
0xd85596833BCd3D21Fd7fDfa7D398095c24D861E2,1046296,6,3,3,523148,523148,174382.66666666666,174382.66666666666,55749.372985014124,55749.372985014124,242003,0
0x805391FE5E62b84bb402a7acF61fc792eb8E719b,871130,2,1,1,435565,435565,435565.0,435565.0,0.0,0.0,435565,0
0x4Ce8BDc18e257dB9ea29D11E290DfbA99431dDd9,43742,2,1,1,21871,21871,21871.0,21871.0,0.0,0.0,21871,0
0x9A4ca42Bf43333406c9E3Fe352Afd684BD93f7Ce,25515684,8,4,4,12757842,12757842,3189460.5,3189460.5,1874451.0648685256,1874451.0648685256,4917250,0
0xCC67717E45e9b2e33E899e70123e9305a1Eb6A75,24655836,6,3,3,12327918,12327918,4109306.0,4109306.0,1140303.7975183045,1140303.7975183045,4917250,0
0x7fEcB54BF233D7099eD4813d5AE709C38413479C,1780190,18,9,9,890095,890095,98899.44444444444,98899.44444444444,47626.447928088375,47768.695542190275,159394,0
0xcCB81f9278f77c363DA9c87bC002cf4B081a598f,198138,2,1,1,99069,99069,99069.0,99069.0,0.0,0.0,99069,0
0xD1E197F5CB700f511267C83Fed933B58c276754A,17708,2,1,1,8854,8854,8854.0,8854.0,0.0,0.0,8854,0
0x930c7e2C80616C09D730E06B3017132f28ac95F1,35318,2,1,1,17659,17659,17659.0,17659.0,0.0,0.0,17659,0
0x60877C45e915D8624aE7733dCee916EE0FAb39b8,1772,2,1,1,886,886,886.0,886.0,0.0,0.0,886,0
0xFf83A46531B056c32f4Cd6Cc271a29a825E7f51F,53090,2,1,1,26545,26545,26545.0,26545.0,0.0,0.0,26545,0
0x7780dC16F146A0Cf4E36D9525D59fAB42734704d,23026,2,1,1,11513,11513,11513.0,11513.0,0.0,0.0,11513,0
0xb1322091E8C08830dD6b29B754cC5CCF5e3dfFFa,35448,2,1,1,17724,17724,17724.0,17724.0,0.0,0.0,17724,0
0xc9b34B026C89F1DB2AA1421b7b7d755b14137A2F,3546,2,1,1,1773,1773,1773.0,1773.0,0.0,0.0,1773,0
0x0CB9Df3390C5f87A934C820Fb50BCAfcED5AF51e,5312,2,1,1,2656,2656,2656.0,2656.0,0.0,0.0,2656,0
0xE707028Cf90Bf0bD3b0190510f756150c2b010E3,3518452,2,1,1,1759226,1759226,1759226.0,1759226.0,0.0,0.0,1759226,0
0xE7e323Fb0525F468D2Ff805f484D003053E94787,3514,2,1,1,1757,1757,1757.0,1757.0,0.0,0.0,1757,0
0x3a06AC2c7a4C55657ddF395Ea30fC39De94cED0e,354246,2,1,1,177123,177123,177123.0,177123.0,0.0,0.0,177123,0
0xa073D547E133447ACDdc6311F109c661b40B31Bb,35400,2,1,1,17700,17700,17700.0,17700.0,0.0,0.0,17700,0
0x0879ec753058Bc52dC2Ef1A1408FC8AB4Aa66d03,295786,2,1,1,147893,147893,147893.0,147893.0,0.0,0.0,147893,0
0xFe2F0c099029d5De4391C26b3359B00B43868019,3538,2,1,1,1769,1769,1769.0,1769.0,0.0,0.0,1769,0
0x720368523453911fB3C5139F690aB5Cd5a9b8b26,3544,2,1,1,1772,1772,1772.0,1772.0,0.0,0.0,1772,0
0x156A600d8a08374d2BBDa77da0957EbE2C713D70,26578,2,1,1,13289,13289,13289.0,13289.0,0.0,0.0,13289,0
0x158452569C63Ca861B106F2FD5AeC53beaC3FAbA,3544,2,1,1,1772,1772,1772.0,1772.0,0.0,0.0,1772,0
0xb376D4dB16C750F0301418664410f58891acF54d,33626,2,1,1,16813,16813,16813.0,16813.0,0.0,0.0,16813,0
0x7920e7eab0ec4d3a77Dd917f7B4089b74489F112,35414,2,1,1,17707,17707,17707.0,17707.0,0.0,0.0,17707,0
0xd0FFCe55FBC71c673DF7eF5E78A16efb5E3ed163,31456,3,2,1,15728,15728,7864.0,15728.0,989.0,0.0,15728,0
0xF3f9D2C6F8Be25918bD62e694Fca2e29Ba09cD72,26556,2,1,1,13278,13278,13278.0,13278.0,0.0,0.0,13278,0
0xbd91649A718f69E83A0C2B1037C69c6463B24Eb2,46250,2,1,1,23125,23125,23125.0,23125.0,0.0,0.0,23125,0
0x1693dFfF63B920e3F4F56599C34Ad5c480F19e7b,51574,2,1,1,25787,25787,25787.0,25787.0,0.0,0.0,25787,0
0xFf4cda04E37A2706c6583218FE2c9ed4FfD81053,44234,4,2,2,22117,22117,11058.5,11058.5,2215.5,2215.5,13274,0
0x7ec135886Ef71A6DFaE79aDE67bd88560001A398,51720,2,1,1,25860,25860,25860.0,25860.0,0.0,0.0,25860,0
0xbAe591120e52DA4A26DA5E0023F9724cdF3cDC57,19466,2,1,1,9733,9733,9733.0,9733.0,0.0,0.0,9733,0
0x283AAdD18f60424d3bAe434A34b9f84B6e2859dE,69890,2,1,1,34945,34945,34945.0,34945.0,0.0,0.0,34945,0
0x52fdf9E1c149DDE7B7C0d98ca43Ed3d3B06fb4A0,70764,2,1,1,35382,35382,35382.0,35382.0,0.0,0.0,35382,0
0x916565201113caE2fB59Ae84A597108Ed0454443,26532,2,1,1,13266,13266,13266.0,13266.0,0.0,0.0,13266,0
0xC59E0A0ee35080227B379141Cb2483A814D6DC00,35380,2,1,1,17690,17690,17690.0,17690.0,0.0,0.0,17690,0
0xafBCCB60cC30Aa31C0B921F8783bd427e210f8b7,70756,4,2,2,35378,35378,17689.0,17689.0,1.0,1.0,17690,0
0xB49A10DB6ee330BCd4E3fA69747de7b5c8F20302,22994,2,1,1,11497,11497,11497.0,11497.0,0.0,0.0,11497,0
0xb1E1F055f1ce31Dfa5FD330785947De0e311E8f0,36100,2,1,1,18050,18050,18050.0,18050.0,0.0,0.0,18050,0
0xd14055388812a441bc880003743C6c21eA257F74,26530,2,1,1,13265,13265,13265.0,13265.0,0.0,0.0,13265,0
0xB772f87cdb27F3e0eDB84FE9868d6588723443Fc,433344,2,1,1,216672,216672,216672.0,216672.0,0.0,0.0,216672,0
0xdbadD4378ae12168C729C4a4141652307A5a6af3,42596,4,2,2,21298,21298,10649.0,10649.0,2662.0,2662.0,13311,0
0x2B182011DA8872F63bB9579ebA0f223D8B31A450,8874,2,1,1,4437,4437,4437.0,4437.0,0.0,0.0,4437,0
0x259EDf6E4Ee7FB85f88B10007E014cB47F43C6d6,621470,2,1,1,310735,310735,310735.0,310735.0,0.0,0.0,310735,0
0x7b68963E7B534bfaeD7f3D9b688A65f5A5e979c3,49500,1,1,0,49500,0,49500.0,0,0.0,0,49500,49500
0x00C980F967b3E94e471C94d226Da998E1eb55A33,53302,2,1,1,26651,26651,26651.0,26651.0,0.0,0.0,26651,0
0x7c68E5fC54201ac5f203A97eDb5633AB9Db30dBf,195276,2,1,1,97638,97638,97638.0,97638.0,0.0,0.0,97638,0
0xE7f7C8A645b12C383dB6f838f6316934C5579285,859506,4,2,2,429753,429753,214876.5,214876.5,522.5,522.5,215399,0
0xd2d3F1A1299fa3181F9b8f7619410B1ce1825BbE,88666,2,1,1,44333,44333,44333.0,44333.0,0.0,0.0,44333,0
0x1d5590436811f11e3b89Ee74Cb096AbB4ecd0A2b,379774,4,2,2,189887,189887,94943.5,94943.5,82589.5,82589.5,177533,0
0x74c16Dc2976F27A7461eA218334aEeBeEEaDcB5B,5009,1,1,0,5009,0,5009.0,0,0.0,0,5009,5009
0xc94Fcb4fc59D0cC11C1f07C238b8fF9FF99F27cA,567650,4,3,1,283825,283825,94608.33333333333,283825.0,4350.413339238264,0.0,283825,0
0xfAdE3F71dA699F8e1568588349767C8563b25DE8,17730,2,1,1,8865,8865,8865.0,8865.0,0.0,0.0,8865,0
0xdcD6001d2153e09EE2be6bf3A66E4127722581A9,242332,2,1,1,121166,121166,121166.0,121166.0,0.0,0.0,121166,0
0x1c34e547bd2F946536E832F0E9812a0EfB0995A3,123226,6,3,3,61613,61613,20537.666666666668,20537.666666666668,4308.890138100787,4308.890138100787,26625,0
0x9a9A10b72A8a11C9964fbfAa411Aef52FEaEcb53,4438,1,1,0,4438,0,4438.0,0,0.0,0,4438,4438
0x20709d7Aa729af0081315A48b878A78D8C5B0a36,220198,2,1,1,110099,110099,110099.0,110099.0,0.0,0.0,110099,0
0x218BaD5A7f11e2dE96f3B8F8EDa979055f44598c,5294,2,1,1,2647,2647,2647.0,2647.0,0.0,0.0,2647,0
0xC445E7fb794c958164D89eF60852649d3F107fd6,2466,1,1,0,2466,0,2466.0,0,0.0,0,2466,2466
0x30d647044c0C9a67B2080ff7D9B67e85496F3461,70550,2,1,1,35275,35275,35275.0,35275.0,0.0,0.0,35275,0
0xeeF936FdC24FcF441bde094199aBa30A248BF145,317246,2,1,1,158623,158623,158623.0,158623.0,0.0,0.0,158623,0
0xB5A5C54b55d26942ffB66C116A0725BD1e06A841,2704560,6,3,3,1352280,1352280,450760.0,450760.0,7072.175902789749,6814.33782549706,457872,0
0x8502C288B36b0429329335817Fce55B8FD0Df026,3534,2,1,1,1767,1767,1767.0,1767.0,0.0,0.0,1767,0
0x9f8e21a419679B64A6720b15e9a733Eacd6A0ca0,17670,2,1,1,8835,8835,8835.0,8835.0,0.0,0.0,8835,0
0x74a2acae9B92781Cbb1CCa3bc667c05313e14850,357698,2,1,1,178849,178849,178849.0,178849.0,0.0,0.0,178849,0
0xeb363Bbf7c852c3d7752898973e1C964895478C5,750,1,1,0,750,0,750.0,0,0.0,0,750,750
0x20C467db9B9Fe0fA39D879b3f23c475582Da2Fba,176294,2,1,1,88147,88147,88147.0,88147.0,0.0,0.0,88147,0
0x30E0e893be003A01c64c9DFC434C13016CD1ccF0,176280,2,1,1,88140,88140,88140.0,88140.0,0.0,0.0,88140,0
0xe1B69d0B4E5f42BA80db984121C880Ea8c2F49a1,44326,2,1,1,22163,22163,22163.0,22163.0,0.0,0.0,22163,0
0x85BE6c8078c663d19d783BA006f797b2A544B089,6403848,2,1,1,3201924,3201924,3201924.0,3201924.0,0.0,0.0,3201924,0
0x0E31f60b31D808389e7E0346Ac1f6c2D669b2888,53510,4,2,2,26755,26755,13377.5,13377.5,4514.5,4514.5,17892,0
0x9B0c70e533B29EE545a61fFc3385931354B7C056,875136,2,1,1,437568,437568,437568.0,437568.0,0.0,0.0,437568,0
0x2a51F954cB51eA610602e0bfCf6486934595fF63,55926,1,1,0,55926,0,55926.0,0,0.0,0,55926,55926
0x378b24028Ca8A8Adc331D6Dc080f15823851D7e7,109844,2,1,1,54922,54922,54922.0,54922.0,0.0,0.0,54922,0
0x5AEe676382E26F1fC224007B045f98e3AB15aa31,1991620,3,2,1,995810,995810,497905.0,995810.0,35.0,0.0,995810,0
0x30410016B4F5ac8e111a8aeA6052e29E07DCe17B,5312621,4,4,0,5312621,0,1328155.25,0,443662.72009904945,0,2071152,5312621
0xd04f0A07C2442f85627bD27c7aE42D7d609621b0,37456,1,1,0,37456,0,37456.0,0,0.0,0,37456,37456
0xaaB654c9f5f6ecCeDD83c927656C8564F8767082,128974,1,0,1,0,128974,0,128974.0,0,0.0,128974,0
0x59bED77fD0690258Be0EafAB85A6892253519Df8,2600,1,1,0,2600,0,2600.0,0,0.0,0,2600,2600
0x07a28Cd0105157a82803b3540e6631F2AfF5E26d,6987,1,1,0,6987,0,6987.0,0,0.0,0,6987,6987
0x2E3bd0f7155dFc0147d4B4a26B95086F54c6405c,87880,2,1,1,43940,43940,43940.0,43940.0,0.0,0.0,43940,0
0x810955105Cffe6404Ffbfb38238b47aC06b25D9e,6650112,4,2,2,3325056,3325056,1662528.0,1662528.0,335270.0,659158.0,2321686,0
0x6a0878ED88FD71a6EcF3cc9A842EeA13C5F008C3,2564456,1,0,1,0,2564456,0,2564456.0,0,0.0,2564456,0
0x74de059EAba74D9A8fc1758C8F758372DcC1F0ba,24600,2,1,1,12300,12300,12300.0,12300.0,0.0,0.0,12300,0
0x3A47d0775Ff73C83AA3273708479507DbB616BA6,52582,2,1,1,26291,26291,26291.0,26291.0,0.0,0.0,26291,0
0xC80dBD4927C546b96cB7ee4012aede43a598c5f3,90590,2,1,1,45295,45295,45295.0,45295.0,0.0,0.0,45295,0
0xF090e2e68A34eF13F0C5a4E346a868849fDF52A3,27592,2,1,1,13796,13796,13796.0,13796.0,0.0,0.0,13796,0
0x8235A7FFaAF5Dfb399dC8D8E14207F35E420962f,50381312,7,4,3,25190656,25190656,6297664.0,8396885.333333334,66.8692754559222,2968675.862285219,12595227,1410559
0x0000Cd00001700b10049DfC947103E00E1C62683,4508886,3,2,1,2254443,2254443,1127221.5,2254443.0,128524.5,0.0,2254443,0
0x36dc271a90A98075c686d703285f3a55DfF91C00,32276956,19,4,15,16138478,16138478,4034619.5,1075898.5333333334,4003965.9640587294,1107212.198453146,9646478,0
0x1231DEB6f5749EF6cE6943a275A1D3E7486F4EaE,71370290,29,15,14,35685145,35685145,2379009.6666666665,2548938.9285714286,2829601.260247096,3383980.7373942104,11998854,0
0x0dC49C0Aa820558FD38787C9a223F64BA1e80C97,1036440,6,3,3,80838,955602,26946.0,318534.0,2023.4828061208393,393423.4554099014,874764,0
0xCfa8F32D232461BC942250e525566D484e5d3b87,57092,1,0,1,0,57092,0,57092.0,0,0.0,57092,0
0xa995198F6B98CCaaBe76cCad54B98eff89379f66,57092,1,1,0,57092,0,57092.0,0,0.0,0,57092,57092
0x55119915d291B22eBDbEB80dbBe1545f1f1c65BA,194432,2,1,1,97216,97216,97216.0,97216.0,0.0,0.0,97216,0
0x28FCb1C2c9520043E37B6418Ca6Ec35571f034D2,173218,4,1,3,86609,86609,86609.0,28869.666666666668,0.0,6072.453339100726,86609,0
0x3AC7Ded03672481881D86A1A27e08e58B89B973D,4647969,3,2,1,1788364,2859605,894182.0,2859605.0,80596.0,0.0,2859605,0
0x6B6f75C0623AdE6d7C9956698a052064474B9d95,2167019,1,1,0,2167019,0,2167019.0,0,0.0,0,2167019,2167019
0xd4d20B78c4109be45880eBe1886B761C9e1B422E,1556425,1,0,1,0,1556425,0,1556425.0,0,0.0,1556425,0
0xD7A9eF840e465670d87767A0ddA218Ab285A359E,3112850,2,1,1,1556425,1556425,1556425.0,1556425.0,0.0,0.0,1556425,0
0xC9Bb6aeBb235b06b68Ab37A9D918134a21a66622,1278852,2,1,1,639426,639426,639426.0,639426.0,0.0,0.0,639426,0
0xc45efB2Dd9c5bB889970E6159C229F3ef4312bfC,3107850,2,1,1,1553925,1553925,1553925.0,1553925.0,0.0,0.0,1553925,0
0xC3087FDF4b0eA058048Dac07f4E4b37F500B14B7,5000381,1,0,1,0,5000381,0,5000381.0,0,0.0,5000381,0
0x29D95F644faf54Ea0725FafCD1904eBfA66135Ad,10000762,2,1,1,5000381,5000381,5000381.0,5000381.0,0.0,0.0,5000381,0
0xd5199E6B7bbf19D37C7Bba0f4a3881a7eA28bd2B,25196,1,1,0,25196,0,25196.0,0,0.0,0,25196,25196
0xE0EF36a17594A8595E00f4bb8Bf4c58049fb55Bb,1599188,2,1,1,799594,799594,799594.0,799594.0,0.0,0.0,799594,0
0x6576410CA3789b2C086CbbE539f57c024B3704c2,75311667,7,3,4,25190656,50121011,8396885.333333334,12530252.75,2968675.862285219,19977603.21914638,47111011,0
0x5A157cC4Ff5b06201d638539CfE8907a2764cC08,24648415,5,2,3,7755734,16892681,3877867.0,5630893.666666667,3113867.0,2720485.3944593947,8995000,5434182
0xC7d08013e8CaD4080E0482ff93d1D14D25EDB2E5,13758702,12,12,0,13758702,0,1146558.5,0,807581.8156282475,0,2153600,13758702
0xA69494A12973002C2feC0AD0c49f426Af3e13CAc,19439976,2,1,1,9719988,9719988,9719988.0,9719988.0,0.0,0.0,9719988,0
0xDF1F6587aa741Ff62cABB9BED8daD062713cf3eC,26100295,14,7,7,13051196,13049099,1864456.5714285714,1864157.0,382739.5824865246,382286.22512794187,2397000,2132
0x41EA27990fdF0c339632f8b984E7D4171786502F,9885650,1,1,0,9885650,0,9885650.0,0,0.0,0,9885650,9885650
0xb0B4aaE8E598a74693bf3B4FB152515933203A86,3138300,3,3,0,3138300,0,1046100.0,0,757753.645102857,0,1997500,3138300
0xeCED7F6A41C85bA01542aD185CC8ef67EA57AeB9,8658,2,1,1,4329,4329,4329.0,4329.0,0.0,0.0,4329,0
0xeee4b45b7766ebBd81C0C19c76Cb07fb5152F0CE,340643,1,1,0,340643,0,340643.0,0,0.0,0,340643,340643
0x1B72212F7c3123372Dcc631f547a52E356618A99,478064,2,0,2,0,478064,0,239032.0,0,215129.0,454161,1
0xdE9a08397Eb82Ee4859bB247B81B979B64D001f6,108194,1,0,1,0,108194,0,108194.0,0,0.0,108194,0
0x98f4EdF4e44b9e720eaeF16Bd934FA208AEb8A93,216388,2,1,1,108194,108194,108194.0,108194.0,0.0,0.0,108194,0
0x5DB8d1Eae17369c15aA0380493737f751eF11196,88288,1,0,1,0,88288,0,88288.0,0,0.0,88288,0
0x6d6be9eBE75De39e370e68E36F5C4FeD0446F401,2332161,1,1,0,2332161,0,2332161.0,0,0.0,0,2332161,2332161
0xbeeC796A4A2a27B687e1d48EFAd3805D78800522,1531,1,1,0,1531,0,1531.0,0,0.0,0,1531,12944
0x5829C822e2464B302861599C20f4c44599bdf1cf,32800,2,1,1,16400,16400,16400.0,16400.0,0.0,0.0,16400,0
0x19b6e573a95eDb59d6Ad6c4879E115D9d145F7CE,1040443,10,4,6,424200,616243,106050.0,102707.16666666667,29320.858207085275,58853.83377321783,192040,0
0x3Abc767BD80D198Db093A93079C3DC627eb609a4,384080,2,1,1,192040,192040,192040.0,192040.0,0.0,0.0,192040,0
0xC882b111A75C0c657fC507C04FbFcD2cC984F071,338580064,2,1,1,237654578,100925486,237654578.0,100925486.0,0.0,0.0,237654578,136729092
0x22F9dCF4647084d6C31b2765F6910cd85C178C18,40682748,120,44,76,20341374,20341374,462303.95454545453,267649.65789473685,643422.3665170546,538189.9854568712,2981455,0
0x86Bf00295448288735651022669E1aD0cEecad1f,112135,2,1,1,20147,91988,20147.0,91988.0,0.0,0.0,91988,0
0xbd9420A98a7Bd6B89765e5715e169481602D9c3d,17642,2,2,0,17642,0,8821.0,0,13.0,0,8834,17642
0x5c7b613E947ffDE9818F7507106Fad5f58969F03,2003872,2,2,0,2003872,0,1001936.0,0,1062.0,0,1002998,2003872
0x05968D2EDdF25F0eC8BA0539b03e8E807437aF89,15000,2,1,1,7500,7500,7500.0,7500.0,0.0,0.0,7500,0
0xb92a1D513660c62f98F819cB072BBD11D09dFaaf,1102200,5,4,1,551100,551100,137775.0,551100.0,94935.69863333814,0.0,551100,0
0xb7304Cf69Ae1F7Ab1743831D98D772B550BEA548,1003370,1,1,0,1003370,0,1003370.0,0,0.0,0,1003370,1003370
0x5f74223E369bF33D80a1e945eD023ef9E81Ea183,30775010,2,0,2,0,30775010,0,15387505.0,0,13612495.0,29000000,30000001
0xC38aB8345F1cAD020aFcD697c8Bb829383ECF290,100459,2,1,1,50459,50000,50459.0,50000.0,0.0,0.0,50459,459
0xdf7736e18b9003FD04c6cA8dEF7C37B40E9B7Ecf,40732,2,1,1,20366,20366,20366.0,20366.0,0.0,0.0,20366,0
0xf57ff8402b2dD81AAC556019f332073Ba66dDC35,8064,2,1,1,4032,4032,4032.0,4032.0,0.0,0.0,4032,0
0xf572C19FF18D4F90F30cc9eBdCF68d8E3704CCF5,40034,3,3,0,40034,0,13344.666666666666,0,3881.561999447588,0,18500,40034
0x9901630c7e97B62e120A70eca35F6240345397C7,497,1,1,0,497,0,497.0,0,0.0,0,497,497
0x0424e057c2D0bC7e58C75975AAF38BF1e598cd49,1000000,1,0,1,0,1000000,0,1000000.0,0,0.0,1000000,0
0x5cdB9DDA1934540C4Da66d5Edc1C62a064f0F146,20366,1,1,0,20366,0,20366.0,0,0.0,0,20366,20366
0xe8452fe0Aa7189aDA800dC83528c780E17FdC1dB,6467,1,1,0,6467,0,6467.0,0,0.0,0,6467,6467
0x1225B6457D066DbC4CB369521196e28D1ce9fF08,989855,1,1,0,989855,0,989855.0,0,0.0,0,989855,989855
0x96BA0B39dA3b71d2404F49B13507E2F92Cd3c533,9454,1,1,0,9454,0,9454.0,0,0.0,0,9454,9454
0x9B2C6e59C8CE703e3612A865Ba41A819d6c7CaA1,2965546,2,1,1,1482773,1482773,1482773.0,1482773.0,0.0,0.0,1482773,0
0xE69712e1117382e619294797FFAe7fC7B42C0299,16600,2,1,1,8300,8300,8300.0,8300.0,0.0,0.0,8300,0
0x57A74134aE6D8012b48b186E240ABdf72A7972F3,74086,2,1,1,37043,37043,37043.0,37043.0,0.0,0.0,37043,0
0x2d177D7B2C030DA4D8AA46B25DcEAEa1bdC31297,2314562,2,1,1,1157281,1157281,1157281.0,1157281.0,0.0,0.0,1157281,0
0x614697ed02B10cB8FF3971f21D3AEF6448E912ac,1435670,1,1,0,1435670,0,1435670.0,0,0.0,0,1435670,1435670
0x33Cd371fB372DA7d76cBb16089D1F7dBccFb7d28,18271143,7,2,5,12751371,5519772,6375685.5,1103954.4,97848.5,421124.97946932574,6473534,7231599
0x337B2436D0e4360e5d245820Ae3d217E450D8aFF,80098,2,1,1,40049,40049,40049.0,40049.0,0.0,0.0,40049,0
0x2fEb74D8eaA7f90834FAEbc2E1C09B92c6743374,187200,2,1,1,93600,93600,93600.0,93600.0,0.0,0.0,93600,0
0x3076399CD238655BfB2Ab92F28221D470a74B035,17990000,2,1,1,8995000,8995000,8995000.0,8995000.0,0.0,0.0,8995000,0
0x580B0b0b4330ECC8c8B19dd36B8946d440641883,90590,2,1,1,45295,45295,45295.0,45295.0,0.0,0.0,45295,0
0x7800BC1D0aEdC98842d191A3084Ea4e843BA6252,17330,1,0,1,0,17330,0,17330.0,0,0.0,17330,0
0x3853e3E1C2138F78EA3043F094bE1230D59f441C,34660,2,1,1,17330,17330,17330.0,17330.0,0.0,0.0,17330,0
0x926Cc169Fff9104078651480A77C2517dc1fCa66,1001606,2,1,1,500803,500803,500803.0,500803.0,0.0,0.0,500803,0
0x1EC44d976f86Ef756cA24Fd51a180FDaDbD4682C,18200,1,0,1,0,18200,0,18200.0,0,0.0,18200,0
0x4e4BE94266681284c2Bb51e89a8074539D19E8d3,39649520,12,6,6,19824760,19824760,3304126.6666666665,3304126.6666666665,903537.9740207689,903537.9740207689,4687015,0
0x3B4B3fc64258F7370DB6F9e37E3626200954eE57,203556,2,1,1,101778,101778,101778.0,101778.0,0.0,0.0,101778,0
0xD171bB4D0C9F2D50EB2d900bFBcf79821563De29,83392,2,1,1,42323,41069,42323.0,41069.0,0.0,0.0,42323,1254
0x8b65031026599228fC63f1144B1456331c2246B8,26931800,2,0,2,0,26931800,0,13465900.0,0,3465900.0,16931800,1
0xF4A0E9f51e11FACE2973f8715ba8339bB3ab0E8b,53863600,4,2,2,26931800,26931800,13465900.0,13465900.0,3465900.0,3465900.0,16931800,0
0xa5Dea41628c19F2D2AAB5Af19f1eaEe0Cc87Cf6c,17330,1,1,0,17330,0,17330.0,0,0.0,0,17330,17330
0x130e35D81455eE3284EeB555B029fD2F612c2AF4,64276494,8,4,4,32138247,32138247,8034561.75,8034561.75,2229713.512627505,2229713.512627505,11225107,0
0x734b549a2b07cf25987dC5abC6B10848E131132d,3993166,2,1,1,1996583,1996583,1996583.0,1996583.0,0.0,0.0,1996583,0
0xE0E35d2b54dA27B47802feAe810Ea98f2332d1d8,1001606,2,1,1,500803,500803,500803.0,500803.0,0.0,0.0,500803,0
0xda43c54Ce5083885F561E05fd6220b7096bE246c,2639606,6,3,3,1319803,1319803,439934.3333333333,439934.3333333333,153533.91793853097,612525.2465677549,1306140,0
0x4899A5eb2c3a2C4B85063cC0c0D0F1A1E81F6751,51629,1,0,1,0,51629,0,51629.0,0,0.0,51629,0
0x4C4387583F3D3681e232FF90390897ccDc9e411F,51629,1,1,0,51629,0,51629.0,0,0.0,0,51629,51629
0xe22619F6D538DE6E0B6c1845174D45e90cBd3576,2512090,13,4,9,2230000,282090,557500.0,31343.333333333332,833317.9165240598,13674.47913287945,2000000,1981314
0x7e300B546736f81884e202963d96a896A4Be2B46,282090,9,9,0,282090,0,31343.333333333332,0,13674.47913287945,0,55999,282090
0x7e9e4c0876B2102F33A1d82117Cc73B7FddD0032,638311522,1,0,1,0,638311522,0,638311522.0,0,0.0,638311522,0
0xA99F29A2fBdCaFbf057b3D8eFC47cfCEe670Bb43,638311522,1,1,0,638311522,0,638311522.0,0,0.0,0,638311522,638311522
0xec5F331525D037241da0f9B4eBFe254bd66d4c94,70000000,2,1,1,35000000,35000000,35000000.0,35000000.0,0.0,0.0,35000000,0
0xb18C171A9173b46A0C72a91d7c7fc96f2aeA4Cf1,1195312,6,3,3,597656,597656,199218.66666666666,199218.66666666666,3604.358965968228,3604.358965968228,204316,0
0xeC68ebAE9537f2A06b2B303e32E1170B0f5BF6Cd,65329480,28,14,14,32664740,32664740,2333195.714285714,2333195.714285714,633026.8577772564,633026.8577772564,2714400,0
0x3a831E590E354b2f04A5A215fc57a7e75afCebe6,1110000,3,0,3,0,1110000,0,370000.0,0,61644.14002968976,440000,1567922
0x34add1b43f885BB28B71A269167292485a17F14F,27777,1,1,0,27777,0,27777.0,0,0.0,0,27777,27777
0xb412a21D52C9797670c2A829bc94D887b6dd4Ef8,902810,2,2,0,902810,0,451405.0,0,74425.0,0,525830,902810
0x95991F45369f10EEDAb77419E8800F0e97d8c6d9,211850,2,1,1,105925,105925,105925.0,105925.0,0.0,0.0,105925,0
0x7e17b943c51590fE6a8b59C42C965544583A5695,12612928,1,0,1,0,12612928,0,12612928.0,0,0.0,12612928,0
0x03Ba854bAfC8AD509d6CD9Dce0d8E52E1FBaa436,14125069,5,5,0,14125069,0,2825013.8,0,4894437.0175911505,0,12612928,14125069
0xE06E1A4E50Dc2070D325AC68960cdA7D318ad3E8,5512565,4,0,4,0,5512565,0,1378141.25,0,654959.8574376047,2512565,0
0x31CAb879BA7b1f35489dDC4614C9F61289977A67,7025130,4,2,2,3512565,3512565,1756282.5,1756282.5,756282.5,756282.5,2512565,0
0xDE47495cc24465d2Dc98cfB0C6772c99D84c4801,300501,1,0,1,0,300501,0,300501.0,0,0.0,300501,0
0x2f2b3A4790FA89C1F71d2338Ad863a35f0C86070,499000,1,0,1,0,499000,0,499000.0,0,0.0,499000,0
0x23861e52B561389e15C0B12cF2A987885C40CE7D,231463,1,0,1,0,231463,0,231463.0,0,0.0,231463,0
0x1417435118190f307d9C5C0d5e111A876151b9d5,325490,1,0,1,0,325490,0,325490.0,0,0.0,325490,0
0x380cA364E22D6841c77D3f10929A3F6Fa69B3baF,6764,1,1,0,6764,0,6764.0,0,0.0,0,6764,22155
0x86d5B94400fA3F22d1B285c770C8f2289443847b,201543,1,1,0,201543,0,201543.0,0,0.0,0,201543,289321
0x2e5E873D3989C6712140E9693620042316004D97,2013274,2,1,1,1006637,1006637,1006637.0,1006637.0,0.0,0.0,1006637,0
0xE4F5B29E6C73e5013B64798FB60E9301244fA317,387150,1,0,1,0,387150,0,387150.0,0,0.0,387150,0
0xCccdd7715845864A640c3E48cAc1163958936c6B,505256,2,1,1,252628,252628,252628.0,252628.0,0.0,0.0,252628,0
0x07aB2c4eaC627Eb18eFA580dCEe0fbEF0cE0213C,195606,1,0,1,0,195606,0,195606.0,0,0.0,195606,0
0x703202dBa22B307306c5ba2c566b76b3B787dc26,505256,2,1,1,252628,252628,252628.0,252628.0,0.0,0.0,252628,0
0xF42A65a988CC5fB359edb98Ae4c1e18D4107e60C,2557,1,1,0,2557,0,2557.0,0,0.0,0,2557,2557
0x34CFAd818ffe66aCD0ac4114BE1b4906BB2a1843,16323190,11,8,3,8161595,8161595,1020199.375,2720531.6666666665,968830.4523398222,2729383.3219238776,6569384,0
0x7dfd31cCE6850DE30dF4eD78111Df4Fe083c336B,16323190,6,3,3,8161595,8161595,2720531.6666666665,2720531.6666666665,2729383.3219238776,2729383.3219238776,6569384,0
0x41dABda77c10CB8144046EefB1520D5607A5B176,808200,2,0,2,0,808200,0,404100.0,0,384100.0,788200,0
0x72c1c354B693Cb5A3c2fC97af1Df10c8df1Fc969,808200,2,2,0,808200,0,404100.0,0,384100.0,0,788200,808200
0xcB4a5F42C8aEeDaA9A9A18c1819a220b1a8bDB1f,2035200,2,1,1,1017600,1017600,1017600.0,1017600.0,0.0,0.0,1017600,0
0xaf8aE6955d07776aB690e565Ba6Fbc79B8dE3a5d,101238836,9,3,6,43117261,58121575,14372420.333333334,9686929.166666666,6066390.842185181,6436163.632787169,22467014,0
0x317E6777eF5d312471071b596fFfb9253CD5E858,123526130,12,6,6,61763065,61763065,10293844.166666666,10293844.166666666,7296082.622154311,7296082.622154311,21539528,0
0xB976d5D34c93311c23644CbaCD89d1C91b10a074,102044,1,1,0,102044,0,102044.0,0,0.0,0,102044,102044
0xD3dd776D0144a02c6c3b190D39E2DAed7dD7Ad14,530172,2,1,1,265086,265086,265086.0,265086.0,0.0,0.0,265086,0
0x9C51838962457e378af722600C7B020e937C0E81,3510157,1,0,1,0,3510157,0,3510157.0,0,0.0,3510157,0
0x10d1D06ca4eacEc6065819eB438F16Be8E373B1C,7020314,2,1,1,3510157,3510157,3510157.0,3510157.0,0.0,0.0,3510157,0
0x328f89d85C37F6063ed8117aD97c7792066750aC,3146874,4,2,2,1573437,1573437,786718.5,786718.5,151999.5,151999.5,938718,0
0x9Af0ad1Ecbd05F1393A99f2904Ab82E8d8F0c0e1,9267,1,1,0,9267,0,9267.0,0,0.0,0,9267,9267
0x64e10aA4d2e41a11f10ACc3a1b34D048422D68CC,187950,2,1,1,93975,93975,93975.0,93975.0,0.0,0.0,93975,0
0xf97cD8F27C9f45087DB3961d0254cd6d2f8b3c5C,35800,1,0,1,0,35800,0,35800.0,0,0.0,35800,0
0x79931BE7aCe00547e3020312DC630D81985e91aE,35800,1,1,0,35800,0,35800.0,0,0.0,0,35800,35800
0x13c41582AA6bE931559bfe585121aCA13d02295b,458000,2,1,1,229000,229000,229000.0,229000.0,0.0,0.0,229000,0
0xc240eA87D7d3Dd02B68465c14806c56F9C2CF4dc,497138,3,2,1,487138,10000,243569.0,10000.0,161168.0,0.0,404737,477138
0xBD0df457Ca8979B0eB5A2491d2b62dFE0177f0d7,10000,1,1,0,10000,0,10000.0,0,0.0,0,10000,10000
0x08CB773432eE16493318AA68e27eb7D768D89857,1067658,2,2,0,1067658,0,533829.0,0,30818.0,0,564647,1067658
0x24988eFa6cAcD20e168C33D021A6D1bE7d13E57b,10489,1,1,0,10489,0,10489.0,0,0.0,0,10489,10489
0x65Dd50e2b411f8A247ee65c470a2b22F59627B4a,23233,4,1,3,14000,9233,14000.0,3077.6666666666665,0.0,39.83577398380618,14000,13687
0x8A3556563af4515e88359320E12e269B7A581F40,6268,2,1,1,3134,3134,3134.0,3134.0,0.0,0.0,3134,0
0x3b35e45486cd951F9130722B8FEf72aA148A749c,23233,4,3,1,9233,14000,3077.6666666666665,14000.0,39.83577398380618,0.0,14000,3988074
0x2D56a676ad18a88BCb5f2131C15B49D442dd8d7e,22491,2,2,0,22491,0,11245.5,0,1154.5,0,12400,22491
0xCa1509c929459694493475b85c865887e2Ef6E20,10634434,5,3,2,5317217,5317217,1772405.6666666667,2658608.5,1023696.6003842262,661829.5,3320438,0
0x17B16E3EB8d162a4D6BCeAE1C533F7f53465BF10,35422514,8,7,1,21721520,13700994,3103074.285714286,13700994.0,488424.3698988219,0.0,13700994,8020526
0x1014c22d536d2De4871Aa38E3B302307bF761742,50,1,1,0,50,0,50.0,0,0.0,0,50,50
0x9C0496712e28695bF597548dDbb6eC0b4a297BC8,155668,4,1,3,77834,77834,77834.0,25944.666666666668,0.0,17719.992199647142,77834,0
0x3E1Aca18700D22ac07A44b2Ec10B18ffe97aF063,645905,2,1,1,500000,145905,500000.0,145905.0,0.0,0.0,500000,526663
0xA612e3476595b356dC914c028F8Bbc5eAf951eE4,2000337,2,2,0,2000337,0,1000168.5,0,567.5,0,1000736,2000337
0xB675AA5e518E696D7E0e0A27a502334dDa628a93,189606,2,1,1,99606,90000,99606.0,90000.0,0.0,0.0,99606,9606
0xE58De2737Df6682f04ddF4C2d8DcfF4D2B69d67B,530600,2,1,1,265300,265300,265300.0,265300.0,0.0,0.0,265300,0
0x8703B82B030e188Cf41cb3297f611A3e0997f8A3,2567385,1,0,1,0,2567385,0,2567385.0,0,0.0,2567385,0
0xa09B793708F91355bD86C4c9accDb5357DDCb82f,18801564,8,4,4,9400782,9400782,2350195.5,2350195.5,220658.4281763332,220658.4281763332,2560152,0
0x3A22Ee1eee30cC2557B42D52F86D9B7Ae09E38Ec,69700,2,2,0,69700,0,34850.0,0,24789.0,0,59639,69700
0xa7fdD34c992B724beE8ee19d5ABb8a4e35C93918,5125089,3,0,3,0,5125089,0,1708363.0,0,840729.2837297072,2882863,0
0xF4D34d7fDd2ED5D57C6F583237bb038Fc3839D17,2562544,2,1,1,1281272,1281272,1281272.0,1281272.0,0.0,0.0,1281272,0
0x79F3e18E7f2ffBcfeFea4a25Cd3910577B455e57,68430,2,1,1,34215,34215,34215.0,34215.0,0.0,0.0,34215,0
0xc11592B638b859D4C9d79Bacc20959f9DCd5616c,502678,2,1,1,251339,251339,251339.0,251339.0,0.0,0.0,251339,0
0xeaf0aDE059e7893b7ce1C905A490BBc9e13Fc810,230000,1,0,1,0,230000,0,230000.0,0,0.0,230000,4900
0xC03a0454B2296a43bA9FBa863Dd46E9Fed850d51,460000,2,1,1,230000,230000,230000.0,230000.0,0.0,0.0,230000,0
0x822f1A8E9598B342020f1074D55Ac8419FF5cdce,2492067,1,1,0,2492067,0,2492067.0,0,0.0,0,2492067,2492067
0xe330c5463C15EEc1FE1da11a4eFC6fC7C7Ebb71e,1043018,4,2,2,521509,521509,260754.5,260754.5,45393.5,45393.5,306148,0
0x489F39b8907c6234E432f018218717D7A943f4Ba,700464,2,0,2,0,700464,0,350232.0,0,101683.0,451915,299536
0xD7C206Ca2fe5e64C35CBAC0fd91fEab123F24a7d,700464,2,2,0,700464,0,350232.0,0,101683.0,0,451915,700464
0xD64c96f057CE9ca913d363F8D115b3FB1Ef1C51E,6739993,2,0,2,0,6739993,0,3369996.5,0,369996.5,3739993,0
0x5550D13389bB70F45fCeF58f19f6b6e87F6e747d,13479986,4,2,2,6739993,6739993,3369996.5,3369996.5,369996.5,369996.5,3739993,0
0xC750359CBa44aD5214f0ccD99900b99099dc92f1,23693967,24,16,8,12120164,11573803,757510.25,1446725.375,216350.49058717777,996124.1953312019,3858770,546361
0x299cD32553E27CF68330a8C81EA6a097ca6d30FA,37997,1,1,0,37997,0,37997.0,0,0.0,0,37997,37997
0xd1729Efd4a3f800C9Ceb0cc2a942Aae2f6dd8447,236976,1,1,0,236976,0,236976.0,0,0.0,0,236976,236976
0x2a6F513FC9AdbF0A26694798D7871092a715f7a6,20108,5,2,3,10054,10054,5027.0,3351.3333333333335,2517.0,1747.1930504542295,7544,0
0x3f74f11D1BbDCE513c24b141Eef77e02ab48c75c,8540,4,2,2,4270,4270,2135.0,2135.0,375.0,375.0,2510,0
0xcc0c36191635caBbD4aDd930baB2991DcEA7c16e,22632,4,3,1,15088,7544,5029.333333333333,7544.0,2420.8545782200317,0.0,7544,7544
0x19eBf870483bA024003144e7e091AB4cEE0331AE,5012400,2,1,1,2506200,2506200,2506200.0,2506200.0,0.0,0.0,2506200,0
0x2546bDeaDFd1eF2c91086D63783Ae81d148c5247,9188807,1,0,1,0,9188807,0,9188807.0,0,0.0,9188807,0
0x1139F874F6761FfA34E7473Ebc84AA7105c6DE99,18377614,2,1,1,9188807,9188807,9188807.0,9188807.0,0.0,0.0,9188807,0
0xC2AA4ce447EE17b5519733d62A50B514C0F1Bf0f,15088,2,1,1,7544,7544,7544.0,7544.0,0.0,0.0,7544,0
0x46a23820D3422627035F52c87b88115Be4E57E4c,13663,2,2,0,13663,0,6831.5,0,6824.5,0,13656,13663
0x3bE4a116ADF84eCF32d44E9A4Bc2aE4C2Cf45E83,488462,2,1,1,244231,244231,244231.0,244231.0,0.0,0.0,244231,0
0x928b13b84FEA7285e212b95B0f92A4B2c81EE318,3430912,2,1,1,1715456,1715456,1715456.0,1715456.0,0.0,0.0,1715456,0
0x40259C8F84A846758D0074eDca565910632ff3De,291810,2,1,1,145905,145905,145905.0,145905.0,0.0,0.0,145905,0
0x2fdCFF367C074ba9a07cf48118cE334bf263c518,14642577,1,1,0,14642577,0,14642577.0,0,0.0,0,14642577,14642577
0xcB83cA9633Ad057Bd88A48a5B6e8108D97Ad4472,208716538,170,85,85,104358269,104358269,1227744.3411764705,1227744.3411764705,385323.6820565446,385323.6820565446,1781533,0
0x36De2b8fd98DEb8d9AD5aD080DAa8926B4cC982e,8679998,4,2,2,4339999,4339999,2169999.5,2169999.5,140000.5,140000.5,2310000,0
0x58A34D06d2b1a4867785d166c1E8F08b7832B6cF,9245400,6,3,3,4622700,4622700,1540900.0,1540900.0,386185.7152545478,386185.7152545478,1968400,0
0xb741e2F6eEAF1a2482fc5BBE6622d848445f923C,604806,2,1,1,302403,302403,302403.0,302403.0,0.0,0.0,302403,0
0x18709E89BD403F470088aBDAcEbE86CC60dda12e,172282515,2,1,1,86142515,86140000,86142515.0,86140000.0,0.0,0.0,86142515,2515
0x315f139bB3Ee30D6b1d2a5432cde08ea4e2255Ae,2238134,2,1,1,1119067,1119067,1119067.0,1119067.0,0.0,0.0,1119067,0
0xDf3CEBd27d73A27e60EE1186a2c0800B02b33132,2316175,2,1,1,1119067,1197108,1119067.0,1197108.0,0.0,0.0,1197108,0
0x04E4e5aFf5828AAa5009898bfD53D271A87B8a1E,1180000,2,1,1,590000,590000,590000.0,590000.0,0.0,0.0,590000,0
0x49a2FcfcF2B2025C667732eF0435f548aa6CD9Dd,5064952,3,2,1,2532952,2532000,1266476.0,2532000.0,1239724.0,0.0,2532000,952
0xfed9eEdC6bF01b7C9D197B6833E53138564122ec,120293,1,0,1,0,120293,0,120293.0,0,0.0,120293,0
0x53Dc6FDCaF854053DDA4410595dDD758347B626d,240586,2,1,1,120293,120293,120293.0,120293.0,0.0,0.0,120293,0
0xcDd37Ada79F589c15bD4f8fD2083dc88E34A2af2,9640508,12,5,7,4820254,4820254,964050.8,688607.7142857143,1038218.5532970213,656048.175249504,2426100,0
0x2691EaE02cDDB7BA1Fd93550d44B4b8A47b3eC45,121672,1,0,1,0,121672,0,121672.0,0,0.0,121672,0
0x93A89C024c8da7e7F201d37b9a7838d79C05867F,243344,2,1,1,121672,121672,121672.0,121672.0,0.0,0.0,121672,0
0x8343d0C8C7D5ed14002617D118380135DF3B739a,20004700,3,2,1,10009900,9994800,5004950.0,9994800.0,4989850.0,0.0,9994800,15100
0xF69fA9184Dfd5358fc3fF2F0024007848DBD70DB,99139,4,4,0,99139,0,24784.75,0,8865.632700913116,0,36615,99139
0x16873A774E751C44b12c4FCAD94976c63fFfE3BE,37505,1,0,1,0,37505,0,37505.0,0,0.0,37505,5774
0x260B2bF91BF4B440c4f680c1a496eA2cD70173Da,2569877,2,0,2,0,2569877,0,1284938.5,0,717961.5,2002900,0
0xb0456c9831C21b22467D2AD4B8284D403B573698,5139754,4,2,2,2569877,2569877,1284938.5,1284938.5,717961.5,717961.5,2002900,0
0x147596f1648FCDd4f6B99e0848f397f356fd4233,43904,1,0,1,0,43904,0,43904.0,0,0.0,43904,0
0x955d2CA708bb8caccd0BD8DC89ECd7104C9058bf,1223322,3,1,2,611661,611661,611661.0,305830.5,0.0,177523.5,611661,0
0xcc3cAd3d778d41A3252BD5e242d17e7Ce13F2fC0,2530,1,1,0,2530,0,2530.0,0,0.0,0,2530,2530
0xCcE7300829f49B8f2E4AEe6123b12DA64662a8b8,20370000,6,3,3,10185000,10185000,3395000.0,3395000.0,3394112.549695428,3394112.549695428,8195000,0
0xe9759406924477c8A7923F78C40CF40d483d50d1,25039939,9,4,5,12685000,12354939,3171250.0,2470987.8,2964825.827514999,3312215.987344328,8977779,330061
0x0698d76ef35a70ab945826ff7D36ED8c226d8ae7,45608472,17,5,12,22804236,22804236,4560847.2,1900353.0,4854856.9669116065,1140066.2016811422,11798650,0
0x96b6db555633185bE39fF5a9eCf97221eaaF1B77,5565520,1,1,0,5565520,0,5565520.0,0,0.0,0,5565520,5565520
0x75BcAe73f1049cb988419e5A28D9f6030044afF7,128349500,31,24,7,63950000,64399500,2664583.3333333335,9199928.57142857,3762912.191338275,7303588.650346443,22650000,0
0xF3434fb37164A156Fb25c7e63818D4A40D2d9b90,1528,1,1,0,1528,0,1528.0,0,0.0,0,1528,1528
0x7D177fD54a78b304E767877B00DCEa00360a0454,321266,7,6,1,160633,160633,26772.166666666668,160633.0,31916.552358803136,0.0,160633,0
0xc2c55Ec86FdDA7E95b42b50cc08a63277104D58D,4955133,3,3,0,4955133,0,1651711.0,0,1009354.9735955136,0,2374950,4955133
0x65c49E9996A877d062085B71E1460fFBe3C4c5Aa,5124350,4,2,2,2562175,2562175,1281087.5,1281087.5,1056777.5,1056777.5,2337865,0
0x958cE940ec3BCB0c1A8B7b8CB38cF508d6058Df8,975600,2,1,1,487800,487800,487800.0,487800.0,0.0,0.0,487800,0
0xCdA7e8B7b2975dB148406f7955D3619F66Dc1f8e,559780,3,2,1,279890,279890,139945.0,279890.0,68840.0,0.0,279890,0
0x9acA66Ea0AE4373baA9e8125EA0Da38D96430a9c,12198,4,2,2,6099,6099,3049.5,3049.5,0.5,0.5,3050,0
0xBCA407F9A9Ad4017a047DC64664be07F75B351dC,382402,3,2,1,191201,191201,95600.5,191201.0,38357.5,0.0,191201,0
0x8Ef4c165EAD32c95cB1595a6d1036610f78A077D,50000,1,1,0,50000,0,50000.0,0,0.0,0,50000,50000
0x6fE805C30dC98C2A44824DE80Fe020A1De096DC6,3200000000,6,2,4,1600000000,1600000000,800000000.0,400000000.0,799900000.0,234456829.71498185,1599900000,0
0x37D31d17c975d06CC4f8e8c9B32B74e58EB9d3ff,1748302,4,2,2,874151,874151,437075.5,437075.5,206175.5,337075.5,774151,0
0xa9C0cdEd336699547aaC4f9De5A11Ada979BC59a,7900000,5,1,4,3950000,3950000,3950000.0,987500.0,0.0,1291000.1098228071,3950000,0
0x78f21c46E649e1a77aF1b7bb86470909de2AdA93,1185,1,1,0,1185,0,1185.0,0,0.0,0,1185,1185
0x4130D9C537bB5A6eb47e2f23FBC78F307caB95e1,7942,3,3,0,7942,0,2647.3333333333335,0,2878.1285972350547,0,6715,7942
0x01428Fdf3F7534BcCdF6d1495DC8748cb347e07b,14942956,5,3,2,7471478,7471478,2490492.6666666665,3735739.0,1864797.6555586103,964261.0,4700000,0
0xB928f0140584081B2A6B417a9CbED50514AEa8cb,1895145,5,3,2,392263,1502882,130754.33333333333,751441.0,157224.40854679304,406441.0,1157882,0
0x211e14F9d34Bc72e5C071ae9a28BA803E2e08322,437736,3,3,0,437736,0,145912.0,0,2238.13151237068,0,148507,437736
0x74aD1F2f1819A07be869218D7820438fB5B3827D,5822227,1,1,0,5822227,0,5822227.0,0,0.0,0,5822227,5822227
0xf35408693c021fAc847e1830bc1A6698407DcF38,3484666,2,1,1,1715456,1769210,1715456.0,1769210.0,0.0,0.0,1769210,0
0xD4a32498837bb5E9695F50A5de38849cb3337C8f,27654,1,1,0,27654,0,27654.0,0,0.0,0,27654,27654
0x8d8b67380833DE653df177f453Cc08841D732C1F,3623190,2,2,0,3623190,0,1811595.0,0,98693.0,0,1910288,3623190
0x2C4E9d172A428a2706c0b1Ed2898778D52A42991,4018932,2,1,1,2009466,2009466,2009466.0,2009466.0,0.0,0.0,2009466,0
0xa03400E098F4421b34a3a44A1B4e571419517687,1124499654,257,91,166,564829650,559670004,6206919.230769231,3371506.048192771,15821687.654140633,11872513.479915932,135000000,5159646
0xEF3D399ed0eBEc635FFc92379FcbDdA369123e73,2500,1,1,0,2500,0,2500.0,0,0.0,0,2500,2500
0x5E4c5c3535D2eD96f8ED233C1368839E30a5Ee67,1221800,2,1,1,610900,610900,610900.0,610900.0,0.0,0.0,610900,0
0xA237AE45703758Db9b99F05471831BCA45dB233a,12000,2,1,1,8500,3500,8500.0,3500.0,0.0,0.0,8500,5000
0x3bC8E8A0142A0f6EbE3561934759eD4F032Ff1D4,7000,2,1,1,3500,3500,3500.0,3500.0,0.0,0.0,3500,0
0x432De74D0C091802571B459940273A493b9f8809,1527168,2,1,1,763584,763584,763584.0,763584.0,0.0,0.0,763584,0
0x2AD186b2D08EeC40D7d6907c4c3719a4a3a50A1C,32979,1,1,0,32979,0,32979.0,0,0.0,0,32979,32979
0x699BfC001B864b2f09f8aA1Ef0b6595C1163bf80,18699,4,3,1,13875,4824,4625.0,4824.0,2197.3075949139816,0.0,6304,9051
0x1Bf51C145C265D27bA662Df44c3973CB31b27b39,6604453,4,1,3,2026164,4578289,2026164.0,1526096.3333333333,0.0,1003373.3119965316,2426100,603040
0xB715C6e79BDAc781C2932228F0B155b42e7c3234,252050,2,1,1,126025,126025,126025.0,126025.0,0.0,0.0,126025,0
0xFC86A314631c8Cfd03a985a1e57603D172606434,4052328,2,1,1,2026164,2026164,2026164.0,2026164.0,0.0,0.0,2026164,0
0x83D289f7DbE6329356AC0339eceb71f1e28831C8,4852200,2,1,1,2426100,2426100,2426100.0,2426100.0,0.0,0.0,2426100,0
0xF0778DB1FbD0575232ff8EADfd41CA8b059e93af,9439671,3,3,0,9439671,0,3146557.0,0,3044213.2773995977,0,7451719,9439671
0x2aCF7D311b9a20b67F84EBBf8aeC548004122e92,1000000,2,1,1,500000,500000,500000.0,500000.0,0.0,0.0,500000,0
0x27293755B5fD34eB1c9AE3FeD2f9f3FA9d7449F7,25976,1,1,0,25976,0,25976.0,0,0.0,0,25976,25976
0xEE5E33bEb397338A4757834035cbbDeBDF25f6F1,4750598,15,12,3,4006921,743677,333910.0833333333,247892.33333333334,365199.4502173797,65.5252283899534,1398122,3263244
0x476c5c20FcBbAF6eE9585f7864fD74d4821a1a4d,2300,1,1,0,2300,0,2300.0,0,0.0,0,2300,2300
0x42d04CA19E0AFBe899FF22b510C1cAaC1eD85441,8148082,1,0,1,0,8148082,0,8148082.0,0,0.0,8148082,0
0x98f34075bD36dE3435b6C281dF935E2FF2e5b23e,16296164,2,1,1,8148082,8148082,8148082.0,8148082.0,0.0,0.0,8148082,0
0xfc3F6Dd0055807c7931B95B96A8d9Ac119b0729a,2486888,1,1,0,2486888,0,2486888.0,0,0.0,0,2486888,2486888
0xD05f81fBf66E42cb9e23cDFbEEB26De828932865,6118938,2,1,1,3059469,3059469,3059469.0,3059469.0,0.0,0.0,3059469,0
0x46F0834153a0B29Ea22377308aeb5B0ebE5c8C23,47990416,7,2,5,23995208,23995208,11997604.0,4799041.6,1250.0,3969801.8392352834,11998854,0
0x6980a47beE930a4584B09Ee79eBe46484FbDBDD0,5191700,4,2,2,2595850,2595850,1297925.0,1297925.0,208049.0,208049.0,1505974,0
0x98904600F589f53B90B610449dc6a138436C292D,23997708,2,1,1,11998854,11998854,11998854.0,11998854.0,0.0,0.0,11998854,0
0x2cF01b39894c33af97759477EFc0bbeeFB13EDc8,15000,2,1,1,7500,7500,7500.0,7500.0,0.0,0.0,7500,0
0x809C6Ce050c6f1616F3Ef6f5C9C841CF757bAf1E,319522,5,2,3,159761,159761,79880.5,53253.666666666664,26622.5,4601.3795274412605,106503,0
0x74cc41adA69002bED811a14193E1a9B9AB6A89e8,53504,2,1,1,26752,26752,26752.0,26752.0,0.0,0.0,26752,0
0xD84b4436B6aBA0fa348c5Cf35b4682448E94724a,31799197,26,18,8,26369473,5429724,1464970.7222222222,678715.5,899347.489182253,517745.6282555653,3361570,20939749
0xC0CDE4e77a0e17b39cF10dF2327ea2D4374e31F8,14980,2,1,1,7490,7490,7490.0,7490.0,0.0,0.0,7490,0
0xf988496024FaC7164A6Fd850CD74444F12AE4570,3978187,3,3,0,3978187,0,1326062.3333333333,0,470981.6709387131,0,1992131,3978187
0xC48D8A745Eae7b8D2e4Dd7eE9dd4333e047C3eCB,209518,1,1,0,209518,0,209518.0,0,0.0,0,209518,209518
0x920435965a515DBd622d081849077211261167B0,837600,3,2,1,418800,418800,209400.0,418800.0,208400.0,0.0,418800,0
0x6d4Beb94f60ec025e64A375A7dF00980afc34BDE,968710000,48,29,19,484355000,484355000,16701896.551724138,25492368.42105263,17236487.581920866,61072639.070821166,283970000,0
0x3CdD9c1F3379c85fbF03F5D3f24B89883F8533e0,77400,1,1,0,77400,0,77400.0,0,0.0,0,77400,77400
0x4fb312915B779b1339388e14b6d079741Ca83128,380140000,15,2,13,212140000,168000000,106070000.0,12923076.923076924,19930000.0,15612921.366914889,126000000,44140000
0xA714868aE941F3925568a8932F1e1b6987b0C0F7,52570042,40,24,16,26285021,26285021,1095209.2083333333,1642813.8125,327605.7197118434,790648.420516526,3361570,0
0x1aa37091b1C3995227C82D0F58849361246afc87,4092010,1,0,1,0,4092010,0,4092010.0,0,0.0,4092010,4000008
0x206DBFC0baA2131198c8Fc3FC8ED7682338a63cD,8184020,2,1,1,4092010,4092010,4092010.0,4092010.0,0.0,0.0,4092010,0
0x25a78046Dbe4ca237c71e015BcCED0fD734DD7c8,3532758,2,1,1,1766379,1766379,1766379.0,1766379.0,0.0,0.0,1766379,0
0x8955B3907127aB10E4Ab5b57E35Cbe1f1785BB32,2649235,2,2,0,2649235,0,1324617.5,0,229941.5,0,1554559,2649235
0x844EB29d48Bf8A91070F31C267C6F9C23792034c,1419130,1,1,0,1419130,0,1419130.0,0,0.0,0,1419130,1419130
0xc044737e26dcb0bfde3A4C4017550171f57246c0,946228,2,1,1,473114,473114,473114.0,473114.0,0.0,0.0,473114,0
0x12Cbf59b397401Ec5747426b2dd3A77fe6d3238a,16278830,4,2,2,8139415,8139415,4069707.5,4069707.5,3562914.5,3562914.5,7632622,0
0xbA795ea43E02416fe73728e46E3352e15E7A0C43,207499,2,2,0,207499,0,103749.5,0,730.5,0,104480,207499
0x9965e261749683559d6C26DAf442E4A807877198,206038,2,1,1,103019,103019,103019.0,103019.0,0.0,0.0,103019,0
0xDac9A1f454c1cbD7D44fA1bF859B73d132A159F9,278456248,1,0,1,0,278456248,0,278456248.0,0,0.0,278456248,0
0x41318419CFa25396b47A94896FfA2C77c6434040,643670994,4,2,2,321835497,321835497,160917748.5,160917748.5,117538499.5,160907748.5,321825497,0
0xF98774582f19BDf64E8af72a2305d126F6bCf068,43379249,1,0,1,0,43379249,0,43379249.0,0,0.0,43379249,0
0x8C9751FDCd1032117BfEe2E7fcD1bfC672a0656f,54032,1,1,0,54032,0,54032.0,0,0.0,0,54032,102363
0x251D765066C372245099B3bB321Ca0dDA8B33019,1056356,2,1,1,528178,528178,528178.0,528178.0,0.0,0.0,528178,0
0xD97c2C3D68B159D1122b1619e0C1e8A9a780aF4d,467604,2,1,1,233802,233802,233802.0,233802.0,0.0,0.0,233802,0
0xb75925FcC27Fc08fCE502DA6F0b2d5C3e1B3A4bA,6375661,1,0,1,0,6375661,0,6375661.0,0,0.0,6375661,0
0x9e94A30e79542D0dB1b13B3139823207ab9D2182,12751322,2,1,1,6375661,6375661,6375661.0,6375661.0,0.0,0.0,6375661,0
0x90A48D5CF7343B08dA12E067680B4C6dbfE551Be,2864,1,1,0,2864,0,2864.0,0,0.0,0,2864,2864
0x0dCb3C4Ee006652f4e266e3Ba37F43afec83c991,1973730,2,1,1,986865,986865,986865.0,986865.0,0.0,0.0,986865,0
0x91b8504fB5BA8B36F79Fd209F79cd4b69f701eBa,1589756,3,1,2,794878,794878,794878.0,397439.0,0.0,299227.0,794878,0
0xDf6Ad2Bd5e566D6ecCD6743B349943203c969ce2,946228,2,1,1,473114,473114,473114.0,473114.0,0.0,0.0,473114,0
0xe755Ab3bf305D4a8c74C1E81B313AAFFB3Ba2A43,14942956,4,2,2,7471478,7471478,3735739.0,3735739.0,964261.0,964261.0,4700000,0
0x1054f95C91eEb4f85E35AD62D74181260f0B874A,690000,2,1,1,345000,345000,345000.0,345000.0,0.0,0.0,345000,0
0x00Db067B7C807c1999652bE292b176adB9e75a80,44206,1,1,0,44206,0,44206.0,0,0.0,0,44206,44206
0xFB160B5f3073FDAd0C444f27E40981A685C6d91E,991326,2,1,1,495663,495663,495663.0,495663.0,0.0,0.0,495663,0
0xEbed46eEA0eD7d94D7c3765c3Ce16E27a62B2967,3951225,6,5,1,2169134,1782091,433826.8,1782091.0,230993.46056838924,0.0,1782091,387043
0x72Bf9ae252012CaC0af90e847d6462EB84929f0A,1600000000,4,4,0,1600000000,0,400000000.0,0,234456829.71498185,0,599900000,1600000000
0xe856199403048056548940895BD21d4D5de0e27a,24766325,20,8,12,18405183,6361142,2300647.875,530095.1666666666,2160244.2071623774,575663.31428316,6493633,17105611
0xa2390dd59D2387598b21E410aCeE102239d6C651,110452,1,1,0,110452,0,110452.0,0,0.0,0,110452,110452
0x766182bFA8B8790d61c4D7E7912C1C3A6F42cef6,36288,1,0,1,0,36288,0,36288.0,0,0.0,36288,0
0x49dba3ea03442Ca8C89eE7f48A6dFc7D118C3361,5738,1,1,0,5738,0,5738.0,0,0.0,0,5738,5738
0x23C5c40B8fa371A063E0A5591bb15294313f5672,10410,1,1,0,10410,0,10410.0,0,0.0,0,10410,10410
0x0d37AC96F6c77E94C167010e0342e10829432405,49200,1,1,0,49200,0,49200.0,0,0.0,0,49200,49200
0x2a9319d778454419686Fb48a084Fec27aD805bB3,1527168,2,1,1,763584,763584,763584.0,763584.0,0.0,0.0,763584,0
0xF6dA1A5cf5038BC6f8715cC23D9eA2BBccD5c905,1748302,3,2,1,874151,874151,437075.5,874151.0,337075.5,0.0,874151,0
0x947e3492FB1A2d648FEe72FcE61f39Ba23EBFBc8,16163430,2,1,1,8081715,8081715,8081715.0,8081715.0,0.0,0.0,8081715,0
0x60916BF9042178efA44a8D19Cf3564A72dA720B1,3515000,3,1,2,2475000,1040000,2475000.0,520000.0,0.0,475000.0,2475000,1435000
0xE8DAADe9322461F7C2302a0c7589c2dB597786b2,144336,2,1,1,100000,44336,100000.0,44336.0,0.0,0.0,100000,823332
0x618a1212b96049808cD11f138Af4913aBA78A5c0,44336,1,1,0,44336,0,44336.0,0,0.0,0,44336,44336
0xCAb96649ef516208e7e5434c455BCd2eFa3C8896,58000000,2,1,1,29000000,29000000,29000000.0,29000000.0,0.0,0.0,29000000,0
0xC60B3F8B333EE5BCa31c6720e6dFe6E492855188,10400,1,0,1,0,10400,0,10400.0,0,0.0,10400,4
0xCF5a81C196A5EEe4C6F86aCB092081C1bDeb204a,19700,1,1,0,19700,0,19700.0,0,0.0,0,19700,19700
0x219a37BAB3104885E4108023691C6C1e3891Ab29,753937,1,1,0,753937,0,753937.0,0,0.0,0,753937,753937
0xC83FBBB4206d58C07Cd7A3573e50722942E8a743,2014542,3,2,1,1007271,1007271,503635.5,1007271.0,498750.5,0.0,1007271,0
0xa11BCaF46a21C81CDf0fF4068b549fF7a09762d0,11789509,5,1,4,5894755,5894754,5894755.0,1473688.5,0.0,845596.3633535507,5894755,1
0x938A75511F44325b9a5EB75eBe445BBaeb29F305,11895105,2,0,2,0,11895105,0,5947552.5,0,5937552.5,11885105,0
0xfC553876a4599Fa8c85eF26cf67eC55688A0Cd45,23790210,3,2,1,11895105,11895105,5947552.5,11895105.0,5937552.5,0.0,11895105,0
0x00f67DA994cE32BfE56498A451D4d5A6950f256a,2310750,2,1,1,1155375,1155375,1155375.0,1155375.0,0.0,0.0,1155375,0
0xC177808c0746636a0E793a7a65A63de4471321DC,465092,2,1,1,232546,232546,232546.0,232546.0,0.0,0.0,232546,0
0xBFF7Fccf275d6c139f488965Ac836E46975c2b8A,121010,1,1,0,121010,0,121010.0,0,0.0,0,121010,121010
0x4ef906344d253f01A76E0Fdb31804BF4fAA4Bd5A,128438,2,1,1,64219,64219,64219.0,64219.0,0.0,0.0,64219,0
0xF9905e617b1AA10aB2126e895A8fe4eC39356E7d,3981506,2,2,0,3981506,0,1990753.0,0,478998.0,0,2469751,3981506
0x00a01875755F6B82a1d8fbd39a4A39673cA8f746,128438,2,1,1,64219,64219,64219.0,64219.0,0.0,0.0,64219,0
0xE3AF1ad75FCa8c1695Bda96483282857be7B2Cf7,3342366,2,1,1,1671183,1671183,1671183.0,1671183.0,0.0,0.0,1671183,0
0x97d43b2Cb9D81aA96299E13Ee3E8F37b8361b136,8000000,6,0,6,0,8000000,0,1333333.3333333333,0,765216.0188832664,2500000,0
0x6A2D93F9304cA3BEE89540c79BB576A69DD27875,111854,3,2,1,55927,55927,27963.5,55927.0,26468.5,0.0,55927,0
0x40091484A316fD6825a4Cbe03435Ca6345677D1A,731924,1,0,1,0,731924,0,731924.0,0,0.0,731924,0
0xFF5Ec7b895F97A724aA475F07c8aC2FF487cCaA9,1463848,2,1,1,731924,731924,731924.0,731924.0,0.0,0.0,731924,0
0xdf327F1A7cC8089e8bFB97BfCa663F65d1B1Dda2,254548,1,1,0,254548,0,254548.0,0,0.0,0,254548,254548
0x448fc50E99cbffee56755a05954A70A9F98Af9Bb,4172974,2,1,1,2086487,2086487,2086487.0,2086487.0,0.0,0.0,2086487,0
0x6B488250449f8c60a834Eb3d89e7dC48662eC13C,11561,1,1,0,11561,0,11561.0,0,0.0,0,11561,11561
0x3a4B82854a2233C7c1DD83779281F34Bc0379014,11822232,5,3,2,5911116,5911116,1970372.0,2955558.0,1318705.1368674752,2139875.0,5095433,0
0xcA2e9F0AE426E68173443B910987FCd720c8d836,185068,2,1,1,92534,92534,92534.0,92534.0,0.0,0.0,92534,0
0x12c606880657217FF02A96a19d53f3f82a9513A2,961794,2,1,1,480897,480897,480897.0,480897.0,0.0,0.0,480897,0
0x16aBAE927181836C586638B5cE7ea5dC12d272Cb,20811,1,1,0,20811,0,20811.0,0,0.0,0,20811,20811
0x1452421a3dBE7A1F7C58e1b33846824652DbB873,50448,1,1,0,50448,0,50448.0,0,0.0,0,50448,50448
0x4aE2042040FC36fACe725bcA50EC4b3331251edf,5000000,2,1,1,2500000,2500000,2500000.0,2500000.0,0.0,0.0,2500000,0
0xC29F2889FCea858B8520568c380C10af0fe3B2A2,3764040,2,1,1,1882020,1882020,1882020.0,1882020.0,0.0,0.0,1882020,0
0xc9E1d445Bb6E31aF132Ad1e2C913FC9F95FF5d74,3457,2,1,1,2484,973,2484.0,973.0,0.0,0.0,2484,1511
0x74ae00732658078b467102d548d1c34D07e97DFe,7677613,1,0,1,0,7677613,0,7677613.0,0,0.0,7677613,0
0xb3bf24F74241a1DbEB16f8D6f09F5096C6f336fE,15355226,2,1,1,7677613,7677613,7677613.0,7677613.0,0.0,0.0,7677613,0
0x396bbaE00808a16357CA3207D01D3C26B485079D,3693620,2,1,1,1846810,1846810,1846810.0,1846810.0,0.0,0.0,1846810,0
0x564e94541C8D4ec4F6261BC7c67329B5792ED52a,980280,2,1,1,490140,490140,490140.0,490140.0,0.0,0.0,490140,0
0x37EF6C69278b5107dFa058d86E13a1c0cb7F54C9,82618912,21,8,13,41309456,41309456,5163682.0,3177650.4615384615,2300232.094482913,3172652.2099139607,10000001,0
0x5d22045DAcEAB03B158031eCB7D9d06Fad24609b,82988679,6,1,5,17898038,65090641,17898038.0,13018128.2,0.0,8329272.202623669,22467014,1892226
0x191Ec924C8ED2492a38e83Fb0c54A014bf953590,29600,2,1,1,14800,14800,14800.0,14800.0,0.0,0.0,14800,0
0x3E60d86fD1Ce74Ebed6b5Fc330f571c08c893441,2965546,4,1,3,1482773,1482773,1482773.0,494257.6666666667,0.0,640477.7738409211,1482773,0
0xB63554e054797FF08272c87481a7c589333aB00f,389540,2,1,1,194770,194770,194770.0,194770.0,0.0,0.0,194770,0
0x1B785a7bEF97436bf51E63273087938Ced02baCf,5471537,2,2,0,5471537,0,2735768.5,0,1720803.5,0,4456572,5471537
0x05AE6Db565CEaaCBdD0a9DC5fF7c09763B5E3360,50121011,4,4,0,50121011,0,12530252.75,0,19977603.21914638,0,47111011,50121011
0xD38205BBe484Dd5d2ddec580f58E7C82448Ba4e2,502668,1,0,1,0,502668,0,502668.0,0,0.0,502668,0
0xc30C97eDFd1cC4d1ABAcbC0F847BEC06B147AE59,1005336,2,1,1,502668,502668,502668.0,502668.0,0.0,0.0,502668,0
0x4c6591450C245627A6c30d8A8Bcf5EcE501A0679,2337865,1,1,0,2337865,0,2337865.0,0,0.0,0,2337865,2337865
0x30273fE97daa77d2345645982797C4cF9d1bA111,57849604,22,11,11,28924847,28924757,2629531.5454545454,2629523.3636363638,1138209.5727299373,1138342.23287617,4379000,90
0x494030C05209820935d95F46B6F9c7eCa58A5ddC,753141,1,0,1,0,753141,0,753141.0,0,0.0,753141,0
0x6c752B3E57FAFc539bf94964a1dE74Fe2014E377,753141,1,1,0,753141,0,753141.0,0,0.0,0,753141,753141
0xc9433B120b6f33fca0545D7578B13F4890d8d899,2116786,2,1,1,1058393,1058393,1058393.0,1058393.0,0.0,0.0,1058393,0
0x86a475cdeB9CC3Cba1D3AE8CF4726E9e1492Fca9,109020,4,3,1,54510,54510,18170.0,54510.0,8580.245373336747,0.0,54510,0
0x1eF264e0EFa2624D5F750aaAf36B02a2EfFba40A,1271862,4,4,0,1271862,0,317965.5,0,106094.72324649327,0,490514,1271862
0xB4AA79ccCBb7f70FFbcF6f47614b56D3EBFca112,382402,2,1,1,191201,191201,191201.0,191201.0,0.0,0.0,191201,0
0x7293FF43f914182143e2f3339844F858954588e4,94091,1,1,0,94091,0,94091.0,0,0.0,0,94091,94091
0xe89922F3717c5De5C5191c2F76586FfD794D5B9b,2080000,4,2,2,1040000,1040000,520000.0,520000.0,475000.0,475000.0,995000,0
0x615CfDab1EFe4089941A118aE5895599c4F9CdD4,3151756,2,1,1,1575878,1575878,1575878.0,1575878.0,0.0,0.0,1575878,0
0xbF24E10613641930DE0b9F6350FA11c6a48E3a13,8254,2,2,0,8254,0,4127.0,0,759.0,0,4886,8254
0x495128CaC9734c381706Fc8235Cd0c89146E328E,22453600,12,6,6,11226800,11226800,1871133.3333333333,1871133.3333333333,404967.059017013,404967.059017013,2714400,0
0x0827f136C0c5322E4159d560e5881Dd7fE3293fc,395286,2,1,1,197643,197643,197643.0,197643.0,0.0,0.0,197643,0
0xB0b666f2178eF72669a99dF89C5b83577dB0907a,22362,1,0,1,0,22362,0,22362.0,0,0.0,22362,0
0x182A10F6dD6dAab6D3D71F8cEcEA8e36D8E9e8AA,22362,1,1,0,22362,0,22362.0,0,0.0,0,22362,22362
0x6985077eD92279F7e55A1424a43B531957485712,2823518,1,0,1,0,2823518,0,2823518.0,0,0.0,2823518,0
0xA5295A307A89849955c0de7D37995bfddF6b763D,5647036,2,1,1,2823518,2823518,2823518.0,2823518.0,0.0,0.0,2823518,0
0xF2d108cC642Dc986Ea50bAe55B496D294cf601f7,332703,4,1,3,2280,330423,2280.0,110141.0,0.0,147502.4734323688,318700,83751
0x14AfB49f7991E31F6B750cf3b49Dc439eF8fdF2f,637400,2,1,1,318700,318700,318700.0,318700.0,0.0,0.0,318700,0
0xC361Ab70F396aD3E93843c8a16C979aa02935C15,191487516,2,1,1,95743758,95743758,95743758.0,95743758.0,0.0,0.0,95743758,0
0x8AD19B6840E93d40CF878c9eF13aCaa55a434e2A,27799,1,1,0,27799,0,27799.0,0,0.0,0,27799,27799
0x6Fb8b01D9748513645B0913e006F37D29ec57a7f,195824,4,2,2,97912,97912,48956.0,48956.0,0.0,0.0,48956,0
0x0025E8f71e36D18CfcbA049b65612C087006fD6E,95743758,1,1,0,95743758,0,95743758.0,0,0.0,0,95743758,95743758
0x77553FA03919590B2592AB5b1A39802b0D40560F,2629,1,1,0,2629,0,2629.0,0,0.0,0,2629,2629
0x371cD6Ac571431E49689E62F891Dc0D23bd0f75c,93975,1,1,0,93975,0,93975.0,0,0.0,0,93975,93975
0x7ee2448BFF0CacD24ef821D40796cf44C3F90B34,2017890,2,1,1,1008945,1008945,1008945.0,1008945.0,0.0,0.0,1008945,0
0x927A171f1C9598202842dbD4CF98D6F590D396dA,24247087,1,0,1,0,24247087,0,24247087.0,0,0.0,24247087,0
0x50dfa8Fd634cec830bb3Ff94fE0C4D91d2851D10,24247087,1,1,0,24247087,0,24247087.0,0,0.0,0,24247087,24247087
0x16292a0b30A79981df1d54dbfC37b1B7361f631a,129709,1,0,1,0,129709,0,129709.0,0,0.0,129709,0
0x3122a4B9ce523627A89a1Fd76a1Bd14bc9B22531,9751803,4,4,0,9751803,0,2437950.75,0,1518295.0504476023,0,4922088,9751803
0x41aAb9d49d9277Cd606b147c1A825442aeF8609E,746550,3,2,1,373275,373275,186637.5,373275.0,85276.5,0.0,373275,0
0x429Cf888dAE41D589D57F6Dc685707beC755fe63,21978718,14,7,7,10989366,10989352,1569909.4285714286,1569907.4285714286,1416546.4064327977,1416546.4064327977,3745056,14
0x08a8DaBA9209e43d4A2FdAcBad5732994A262b7b,664643,1,1,0,664643,0,664643.0,0,0.0,0,664643,664643
0xeEAbc693c512C9B0C6671066fd2E2C392F4CC2C0,1029300,1,0,1,0,1029300,0,1029300.0,0,0.0,1029300,0
0x6015325B8C32b75d6ec501ad49a737303875c28d,2058600,2,1,1,1029300,1029300,1029300.0,1029300.0,0.0,0.0,1029300,0
0x7072439f28365272C5f2bb472Ca9a3bA5AD2BFF0,168598,2,1,1,84299,84299,84299.0,84299.0,0.0,0.0,84299,0
0x4398A8b71d10C110A4Ff07f52Ab17077555DF06F,13922778,1,0,1,0,13922778,0,13922778.0,0,0.0,13922778,0
0xCF08a2818d1c77bCc7187A7f565612f1bA0BE020,27845556,2,1,1,13922778,13922778,13922778.0,13922778.0,0.0,0.0,13922778,0
0xa701f9dB977C98F9043B20225b4322F94dBd50dB,111030150,84,46,38,55515075,55515075,1206849.456521739,1460923.0263157894,323873.499016924,566995.8618329213,2949873,0
0x10647B6352945c79a729786d2566C78F22DDdfa5,7500000,1,0,1,0,7500000,0,7500000.0,0,0.0,7500000,0
0xE322E78F204e77D9CB87D68f8520F86e48F88BAd,15000000,2,1,1,7500000,7500000,7500000.0,7500000.0,0.0,0.0,7500000,0
0x3F87518da9EECf6024D95ED346C11E3D823A2b36,1825000000,14,7,7,912500000,912500000,130357142.85714285,130357142.85714285,84138794.46898367,84138794.46898367,292500000,0
0xC0BeE04f630E43E1B0E454B4cA62120daaD25BBd,973,1,1,0,973,0,973.0,0,0.0,0,973,973
0x4418306Dd976fC4d39a92438540F5b07e935fE38,1149462,2,1,1,574731,574731,574731.0,574731.0,0.0,0.0,574731,0
0x377412320ff683498b3d0a558C049DE8A9Ac1596,1377836,2,1,1,688918,688918,688918.0,688918.0,0.0,0.0,688918,0
0x0b898D7dbd17F03c3Edf312059fA4deED71224ff,17335,1,1,0,17335,0,17335.0,0,0.0,0,17335,17335
0x48a57C37dC797Ff7eD9fAa72A96007bfEE363A51,937090,3,2,1,468545,468545,234272.5,468545.0,85863.5,0.0,468545,0
0x9393A68e904B1f52A081cdfcF02ec56d842BF239,800684,2,1,1,400342,400342,400342.0,400342.0,0.0,0.0,400342,0
0xF30bCA209f1090329E0760009689a1E3F0698025,2014542,2,1,1,1007271,1007271,1007271.0,1007271.0,0.0,0.0,1007271,0
0x0818E60b1fdEf5753D9D0229Cd96822d06a332d1,54200,2,1,1,27100,27100,27100.0,27100.0,0.0,0.0,27100,0
0xC96114C52d3Fc26627139C93E74891EC08a52B9a,2000000,2,0,2,0,2000000,0,1000000.0,0,500000.0,1500000,0
0x0f5d8D8bE59EcCec5FdBcAe56429075B9bb4d121,4000000,4,2,2,2000000,2000000,1000000.0,1000000.0,500000.0,500000.0,1500000,0
0xd9CaeF8950FFD7f475cD8697b8475800c546be01,3000000,2,1,1,1500000,1500000,1500000.0,1500000.0,0.0,0.0,1500000,0
0xFf7f11826eE04BdEA1aeaf82177851b0B1Df80a7,1000000,2,1,1,500000,500000,500000.0,500000.0,0.0,0.0,500000,0
0xDF86246F633e1A2fCc2Aeb8b55AC20368ef4249b,165766,2,1,1,86783,78983,86783.0,78983.0,0.0,0.0,86783,7800
0xC1542E6D96f16FD9B9BbA467a57d4d68576339ed,2878627,2,1,1,1878627,1000000,1878627.0,1000000.0,0.0,0.0,1878627,878627
0xA6E6A9475Ba6d0a1deC9910CAC64c3570D94b19c,471972,3,0,3,0,471972,0,157324.0,0,42583.90093294257,201972,0
0xC619E0f5eDaC2475367a530d3523bCbb39D412c0,540000,3,2,1,270000,270000,135000.0,270000.0,35000.0,0.0,270000,0
0xF4ec78fd46010c88f7d103FA1392cc0A19F8339C,1530582,3,1,2,765291,765291,765291.0,382645.5,0.0,7354.5,765291,0
0x82b443D66F30a9da68339221997B7ACb776d764F,9819763,4,4,0,9819763,0,2454940.75,0,1730743.324502853,0,4915961,9819763
0x062fd9eC0a4EAD8f09ff3629e0342651e1F0C2Ce,6043,1,1,0,6043,0,6043.0,0,0.0,0,6043,6043
0x427bD9382a709B6E7109157BD5Ab3c90bb1075a2,780000,2,1,1,390000,390000,390000.0,390000.0,0.0,0.0,390000,0
0x6c69fa64EC451b1Bc5b5FBAa56CF648a281634Be,100267131,35,10,25,68037168,32229963,6803716.8,1289198.52,12028173.53326285,1884556.2579582094,36169509,35807205
0x1f50178601De2ac35Fd22a810469008A10ED877D,221600,2,1,1,110800,110800,110800.0,110800.0,0.0,0.0,110800,0
0xAeb000310CbfCd04F555B6E172956F12B27d5B23,4461294,2,1,1,2230647,2230647,2230647.0,2230647.0,0.0,0.0,2230647,0
0xde48ab566938077FfF94d5b5980fA6A012Ee33a4,16156220,2,1,1,8078110,8078110,8078110.0,8078110.0,0.0,0.0,8078110,0
0x1111111254fb6c44bAC0beD2854e76F90643097d,31786620,18,9,9,15893310,15893310,1765923.3333333333,1765923.3333333333,1653567.7073157101,1653567.7073157101,4562780,0
0xCC5d455DAe99dDbbE545Ff7b9321980EF8baaFd7,9125560,2,1,1,4562780,4562780,4562780.0,4562780.0,0.0,0.0,4562780,0
0xCf32CB7EfFe6CFa74994b22129852AF20a453289,385830,2,2,0,385830,0,192915.0,0,28612.0,0,221527,385830
0xD138d9F59296dD3a22Ef0067129122683558d927,52816,3,2,1,26408,26408,13204.0,26408.0,1367.0,0.0,26408,0
0xCa43Adad94D5cb435aAfe8248664d3F6AdCF940a,22644,1,1,0,22644,0,22644.0,0,0.0,0,22644,22644
0x7DB19Bf872e650725685Bb71d8A270d6906dF554,9545048,7,6,1,4772524,4772524,795420.6666666666,4772524.0,742698.8615977243,0.0,4772524,0
0x9cEe52aF031C0fEB5562FF952e82590D35Dd7B5f,109287800,1,0,1,0,109287800,0,109287800.0,0,0.0,109287800,0
0xf89Dc91259b17Fa5dBE64ec664a392D16064F8d4,218575600,2,1,1,109287800,109287800,109287800.0,109287800.0,0.0,0.0,109287800,0
0x160514f1273d61b34A8BcDA5d9ABAc5dC652382d,48000,2,1,1,24000,24000,24000.0,24000.0,0.0,0.0,24000,0
0xFDa9365E2CDf21d72cb0dc4F5FF46F29e4aC59CE,5085685,1,0,1,0,5085685,0,5085685.0,0,0.0,5085685,0
0x2afE7Ab4f4e17399647308812f8b15ef257db6cF,5085685,1,1,0,5085685,0,5085685.0,0,0.0,0,5085685,5085685
0x525145f821D8D2ABb494c454E9445E14c817F7cb,1408584,2,1,1,704292,704292,704292.0,704292.0,0.0,0.0,704292,0
0xe5835Dad0fe3be28d0D0B3EDDD0D386f9502aB75,231674,2,1,1,115837,115837,115837.0,115837.0,0.0,0.0,115837,0
0x15f2e544Bbd11154190A6a8AC3c42228f1def281,4938399,1,1,0,4938399,0,4938399.0,0,0.0,0,4938399,4938399
0xFCe38f23BA43DD6f6Db42496c6Ad9ea17e7D2336,28334,1,1,0,28334,0,28334.0,0,0.0,0,28334,28334
0x604D8431206b11B55d06d28A07752F2E45eE4D84,137259,1,0,1,0,137259,0,137259.0,0,0.0,137259,0
0xC96FF40e032F06AA812794aF944b513da9Cc80D2,137259,1,1,0,137259,0,137259.0,0,0.0,0,137259,137259
0x8BbC71Bf16675Aec6ca0f432eDe7b4048fd77D0B,453775,1,0,1,0,453775,0,453775.0,0,0.0,453775,0
0xAFDf81aca79A8FB55DB0ef4FE48eF5Ee9B101D54,23971185,1,0,1,0,23971185,0,23971185.0,0,0.0,23971185,0
0x2e67494A6EFBaA66f932bce73152f99D7f56288E,95824876,4,2,2,47912438,47912438,23956219.0,23956219.0,14966.0,14966.0,23971185,0
0x9fA1EaB9071b6D500e4BB1516979F776b6d1f4cf,6758292,4,2,2,3379146,3379146,1689573.0,1689573.0,1485303.0,1485303.0,3174876,0
0x715a49Dab2a120c0BFad71Dd13086040bC8Fd2c5,100000,1,0,1,0,100000,0,100000.0,0,0.0,100000,106870000
0xaA17C10B87b3ab2023B93c1E4524713B3894Cb4C,200000,2,1,1,100000,100000,100000.0,100000.0,0.0,0.0,100000,0
0x016DAe516c8c460FA40969bba867f505EfE757e0,3645020,7,3,4,1822510,1822510,607503.3333333334,455627.5,376128.2889452599,251424.958077455,1030778,0
0xD09B972E71F779994bfB83dF5B220DB601d2F6Fc,54200,2,1,1,27100,27100,27100.0,27100.0,0.0,0.0,27100,0
0xDEAa20090e6D4a8b5Bd73412e1753D8089C6cD63,1958429,2,2,0,1958429,0,979214.5,0,503825.5,0,1483040,1958429
0x74103aa5a8261f3572e63270c09E07e1B8B4a27a,428392,1,0,1,0,428392,0,428392.0,0,0.0,428392,0
0x7280DEc619DC42C02BD5E96c675AaBd0E9660DA8,282016,1,0,1,0,282016,0,282016.0,0,0.0,282016,0
0x5043b1c96EE881Bc20D5937cEe57FA43d279AE85,10504,2,1,1,5252,5252,5252.0,5252.0,0.0,0.0,5252,0
0x44F096D825B1300870C43C204d6E544B6812D2C0,38530000,14,7,7,28170000,10360000,4024285.714285714,1480000.0,3733033.4549144083,1134837.9368249648,12410000,25719114
0x612E2F825ad33A1dac061f6c331CF3e0dD42663d,9855193,6,2,4,4900000,4955193,2450000.0,1238798.25,1550000.0,1185921.8582496012,4000000,44607
0x991Ba7298C82966f643429a1c0E4331bc0710eBd,1201490,2,2,0,1201490,0,600745.0,0,320745.0,0,921490,1201490
0x895923aF39f20936BAdA4A237689B7eE1B532429,15200,2,1,1,7600,7600,7600.0,7600.0,0.0,0.0,7600,0
0x11541f5f75F9E06A956376B847929754d6c52924,53060,2,1,1,26530,26530,26530.0,26530.0,0.0,0.0,26530,0
0x5D20d3B581f8Afb6aF73Bf9De316594EA2e8a255,2287501,5,5,0,2287501,0,457500.2,0,496466.0930349222,0,1435182,2287501
0xC7e19D88340ADf1f86b36796ef471391731ACEB2,2338,1,1,0,2338,0,2338.0,0,0.0,0,2338,2338
0xF9399585dFd9Bca59cB916c06A26121B139Ed7E3,20798378,8,4,4,10399189,10399189,2599797.25,2599797.25,1692093.1428301125,1692093.1428301125,5201305,0
0x671cff7e19892c7B84244c84636B1c336464566D,8846551,4,4,0,8846551,0,2211637.75,0,1528861.1244713129,0,4371920,8846551
0x4606887be86edF5bD47eEEAa0851864d9A70B07B,420868,5,3,2,210434,210434,70144.66666666667,105217.0,70698.89442008427,105217.0,210434,0
0x88d70DEBB940E0bEE526981D99B0f3000E0a3268,420868,3,2,1,210434,210434,105217.0,210434.0,105217.0,0.0,210434,0
0xE7e708277A03dA75186C231b5B43FcFB34BEd29B,210434,3,0,3,0,210434,0,70144.66666666667,0,70698.89442008427,169963,3926
0x88d9f941a10a569609eCa31658769C736F6EbF85,10395768,2,1,1,5197884,5197884,5197884.0,5197884.0,0.0,0.0,5197884,0
0xF86b20a56b006EC0899C535361c9ab849ac374f6,10395768,4,1,3,5197884,5197884,5197884.0,1732628.0,0.0,899801.2221789135,5197884,0
0xfC7A3D628807EE3178eFb3f448632db35F4Eff8e,1260000,2,1,1,630000,630000,630000.0,630000.0,0.0,0.0,630000,0
0x55E0180F3Bc6FB7648ef485AE7220F5e8693Ce3b,1801,1,1,0,1801,0,1801.0,0,0.0,0,1801,1801
0xf2254077c48DD74C7Bf4F75D82123666ba62baE6,1262000,2,1,1,631000,631000,631000.0,631000.0,0.0,0.0,631000,0
0xfE4226215265aaC2BEc98483916f2A5588ecb158,50558,2,1,1,25279,25279,25279.0,25279.0,0.0,0.0,25279,0
0xD2F595B6B2656f394418e4299C7e791d3473902D,2800000,2,1,1,1400000,1400000,1400000.0,1400000.0,0.0,0.0,1400000,0
0xd922B5D5E7B5E0D60B304aDE0163870a33201eA2,41600,1,1,0,41600,0,41600.0,0,0.0,0,41600,41600
0xe619cafC87f636b472B680572a043fd77005cA10,930480,4,2,2,465240,465240,232620.0,232620.0,3460.0,3414.0,236080,0
0xdD4D620618532C98474495737EF34bB20e32C5a5,18001,1,1,0,18001,0,18001.0,0,0.0,0,18001,18001
0x08962c36771160cD86127dAbACFC63D0daF84357,30950006,12,7,5,15475003,15475003,2210714.714285714,3095000.6,1737502.2853554315,1243920.845415913,5445714,0
0xE3992B4bB543aC3361493Ee4b6e25748d8084cE9,241247,1,1,0,241247,0,241247.0,0,0.0,0,241247,241247
0x5D0f3cab8859A738460d06D46B151E425081f454,487062,3,3,0,487062,0,162354.0,0,139848.3900967997,0,351837,487062
0x89Dfa6d7d6Bc6A3f39818CBFBdBAEb7A56d53Ff1,523068,2,2,0,523068,0,261534.0,0,252778.0,0,514312,523068
0xC48a92A1e5a0ce3edd13E349Fca503EaC7e53A09,1072462,2,1,1,536231,536231,536231.0,536231.0,0.0,0.0,536231,0
0x8788b0d63f319e7cedc4a9853f31D95009d9F1A5,34417128,41,9,32,16359897,18057231,1817766.3333333333,564288.46875,1063781.3846722038,437435.0374704929,4305103,1302744
0xA1034701EE7678bE2389845353498A7fAac390d9,27988921,29,27,2,15171921,12817000,561923.0,6408500.0,440890.6657431153,4908500.0,11317000,2354921
0x2125a0cA70a7Ef46430D7ba2463Cb696fb136dA7,5064000,2,1,1,2532000,2532000,2532000.0,2532000.0,0.0,0.0,2532000,0
0x3dE931F2862AF3e8134932d919c5875A4dB54BE2,40000,2,1,1,20000,20000,20000.0,20000.0,0.0,0.0,20000,0
0x205F69bcC5AE5701F3E757c429868c0fA51ac279,1007148,2,1,1,503574,503574,503574.0,503574.0,0.0,0.0,503574,0
0x903cAC70c1EcF274e48964BBc1a4e81d2E7E993c,100000,2,1,1,50000,50000,50000.0,50000.0,0.0,0.0,50000,0
0xD41C0e587588c967173BCD1dA472Bac1c9fD613C,554206,8,3,5,277103,277103,92367.66666666667,55420.6,5782.0926046621635,28469.686549732152,100146,0
0x7f23779f5462DaeE41e82916a6B392B14a09642F,152245310,8,4,4,76122655,76122655,19030663.75,19030663.75,21605017.872066334,8586843.75383174,55141931,0
0xcf06A5d47fb01FcA528Baa474a4953f9F92ee333,23397691,12,6,6,11701891,11695800,1950315.1666666667,1949300.0,1098996.2592339152,1099614.4869907817,4272000,6091
0xA9B75B95E754dc9237DbE9b6cF7ADE31FA705bE8,2384408,1,1,0,2384408,0,2384408.0,0,0.0,0,2384408,2384408
0xa7467696cF741e30Ee14461D5A891f579B99B6eA,2332616,1,1,0,2332616,0,2332616.0,0,0.0,0,2332616,2332616
0x7Df79770866997E1dED6262f5dd876A11604FaCC,113155,5,1,4,56578,56577,56578.0,14144.25,0.0,16250.54085830684,56578,1
0x656bF9eBfF137a9d5B1b0b2c59D9Cc3E7fE11373,59076,1,1,0,59076,0,59076.0,0,0.0,0,59076,59076
0x579d2d3605223Dd31d626DBc49DDc4Cb87C87927,10230,1,1,0,10230,0,10230.0,0,0.0,0,10230,10230
0x4666eC1e043eFB14c9103d936C434Fc4288e2194,16973,2,2,0,16973,0,8486.5,0,8486.5,0,16973,16973
0xAeB804e36e4BCE40c9d4b134040B22B2fbEE3F72,39604,2,2,0,39604,0,19802.0,0,19802.0,0,39604,39604
0x4B1E77eB82aC2f8273b3C4369EFDC485BD1e669D,24200,1,1,0,24200,0,24200.0,0,0.0,0,24200,24200
0x1f6486BDf0B8A3866a6Fb1524955F73C9B8C08FA,17465,1,1,0,17465,0,17465.0,0,0.0,0,17465,17465
0x0633bF6784304684eeAE403cBC6889DE67af9535,811806,2,1,1,405903,405903,405903.0,405903.0,0.0,0.0,405903,0
0xc79e217689069ff02c44E1Cb6c03880e9983A092,2239248,4,2,2,1119624,1119624,559812.0,559812.0,153909.0,59812.0,713721,0
0xacac1Dc90C7A4bAd8C0c08FBb46DaDa5B6c42CAc,1930,2,1,1,965,965,965.0,965.0,0.0,0.0,965,0
0xdb9859fE30BDcf020798615f2227860660e6CdF3,61465151,6,1,5,42234360,19230791,42234360.0,3846158.2,0.0,3319228.264129986,42234360,23003569
0x18e3EC5FC225cD4d2b054039988fe48787761CA7,7782,1,1,0,7782,0,7782.0,0,0.0,0,7782,7782
0x7e89f6a0d76E26782877ffA22FC6b25e4e67C369,178329,1,1,0,178329,0,178329.0,0,0.0,0,178329,178329
0xaC2da40941319db67Fb707a0d25C40D34417F851,95824876,4,2,2,47912438,47912438,23956219.0,23956219.0,14966.0,14966.0,23971185,0
0x9462A60E1608587c4ba9A81A3d58d25551773143,171479,1,0,1,0,171479,0,171479.0,0,0.0,171479,0
0x21a842132D27dDa9439e3b3f72B0A9A2bC675765,120339018,4,2,2,60169509,60169509,30084754.5,30084754.5,6084754.5,6084754.5,36169509,0
0x124A863E9FA5393DB10DB10A92ddAd8522Df96FA,354635349,1,0,1,0,354635349,0,354635349.0,0,0.0,354635349,0
0x843661BF02d226c3D1C71dBA5c21f6EefEd24d47,709270698,2,1,1,354635349,354635349,354635349.0,354635349.0,0.0,0.0,354635349,0
0x8A0A019AA6a75BEb0F2132f961D3C384d2C18d09,220154,2,1,1,110077,110077,110077.0,110077.0,0.0,0.0,110077,0
0xbC04b3d15Daf4D32e6F5ED91426ab7437C67ef4b,3564182,2,1,1,1782091,1782091,1782091.0,1782091.0,0.0,0.0,1782091,0
0x060108dd960B7144B550Ad6312050be8A8c40f14,2399,1,1,0,2399,0,2399.0,0,0.0,0,2399,2399
0x22A1DD7cd753BA5c52db23D927fc6ded7025579D,542800,1,1,0,542800,0,542800.0,0,0.0,0,542800,542800
0x4c835d036b1DFEb2610B1455fa52024A903e6f6F,1053028,3,2,1,526514,526514,263257.0,526514.0,219291.0,0.0,526514,0
0x648C69ac817D2124663A27d608da2aAf5Cec9fE0,1488480,3,2,1,491700,996780,245850.0,996780.0,450.0,0.0,996780,0
0xC5db7f0D8a9aFfd8F7571aA3d4bEf359568fC093,45299702,11,7,4,22649851,22649851,3235693.0,5662462.75,2179332.2743598064,4968665.086564769,13365521,0
0x3b60e3A06Af5aa4DA178aaDe658211a0D3F51222,14061215,7,4,3,7030615,7030600,1757653.75,2343533.3333333335,781679.0676839105,1616780.6392815185,4630000,15
0x9D90c8f5a0e687Bd26030120a905E777F33B2f28,3588000,2,1,1,1794000,1794000,1794000.0,1794000.0,0.0,0.0,1794000,0
0x73fB1d96A144efdB278E123A17c79d63cD67D11f,10996408,6,3,3,5498204,5498204,1832734.6666666667,1832734.6666666667,402177.8090491264,402177.8090491264,2394150,0
0xD1742B3C4fBB096990C8950fA635Aec75B30781A,9259640,3,1,2,4629820,4629820,4629820.0,2314910.0,0.0,1111157.0,4629820,0
0x03aFFf09b99332286d3E4813EdE77c35aDF6DAf1,11101318,12,6,6,5550659,5550659,925109.8333333334,925109.8333333334,93806.4813812931,93806.4813812931,987182,0
0x00000000003b3cc22aF3aE1EAc0440BcEe416B40,3663668,4,2,2,1831835,1831833,915917.5,915916.5,327167.5,327166.5,1243085,2
0x62D63eFDFdc7804666725f4Cc8Cb45C1A41A0809,3656222,8,4,4,1828111,1828111,457027.75,457027.75,205871.89054649376,205871.89054649376,744632,0
0x03dc9253337b296FA58377949Fa793359658eC72,10357,1,0,1,0,10357,0,10357.0,0,0.0,10357,60
0x85bdB54890261cDB0072Cc107F48240f5c509cC8,10357,1,1,0,10357,0,10357.0,0,0.0,0,10357,10357
0xD18508F7C4d18d685BEDeaeE4E38ffF239d47B3A,3253703,1,1,0,3253703,0,3253703.0,0,0.0,0,3253703,3253703
0x66cEB65F0637e79F2af6FdA624083E85BaeFC339,22649851,4,4,0,22649851,0,5662462.75,0,4968665.086564769,0,13365521,22649851
0x4c98a3Eeae6f3e9e16eFe7E846B15179261c41F1,86294,1,1,0,86294,0,86294.0,0,0.0,0,86294,86294
0x58fB93b5Af24243e971105Bc72598e49a8B59865,111314,4,2,2,55657,55657,27828.5,27828.5,9169.5,9169.5,36998,0
0x9f67CAb1e32b23f1099eA1DF5e7543A4FB9fBB11,2410,1,1,0,2410,0,2410.0,0,0.0,0,2410,2410
0x3F050316Ee7A4a7cBf64D359E2B1189551c99AE2,12635,1,1,0,12635,0,12635.0,0,0.0,0,12635,12635
0xc1b3488C88DaA656be555fF9eCfFF5d4CCFeDdb3,80537,1,0,1,0,80537,0,80537.0,0,0.0,80537,0
0x60CE55260aCA2e35cc91CBFA009D0970bD9c627f,161074,2,1,1,80537,80537,80537.0,80537.0,0.0,0.0,80537,0
0xeD872dFBAA58Fa19f815825fDE8e72f7C46Ee764,26530,1,1,0,26530,0,26530.0,0,0.0,0,26530,26530
0x2028153FA64B4EEF08C02aA5b2dAea73A4F68fA0,472558,1,1,0,472558,0,472558.0,0,0.0,0,472558,472558
0x01E608397f90Dc6BA5e4be3524143B067A9cADd4,136958,2,2,0,136958,0,68479.0,0,64000.0,0,132479,136958
0x60b160F5982094475D143bE6a4CAbC0bD0298BFf,223803,1,0,1,0,223803,0,223803.0,0,0.0,223803,0
0x570310BCD3F4792c1cB528A954c91Bfe3f024d9f,1007148,2,1,1,503574,503574,503574.0,503574.0,0.0,0.0,503574,0
0x50198f73E15389b8c756933d45Da573518Dc6f78,48610,1,1,0,48610,0,48610.0,0,0.0,0,48610,48610
0x629dC523c2989b89f7B7173Ed29dAaE4985D65Cb,142600,2,1,1,71300,71300,71300.0,71300.0,0.0,0.0,71300,0
0xeFD3345D38758126c7c1806d9E2956FE010df550,2925142,8,3,5,1462571,1462571,487523.6666666667,292514.2,394457.00415493816,169323.1710055065,975830,0
0x6Bf2bD87c9d12d4780719860CF3389eaBC2Df9e0,44052914,12,9,3,22026457,22026457,2447384.111111111,7342152.333333333,3482692.834799578,3300932.843685891,12010375,0
0x7F6F214fA819b177c1A55E03c13B6f105601c535,24087170,3,2,1,12043585,12043585,6021792.5,12043585.0,334673.5,0.0,12043585,0
0xf7d9919e05d87dd6B2c39E04af333beb1a74fc9C,189000,2,1,1,94500,94500,94500.0,94500.0,0.0,0.0,94500,0
0xFe23681f70f78a0f090F77128A49801f33f5C3c8,43600,2,1,1,21800,21800,21800.0,21800.0,0.0,0.0,21800,0
0x7D1b193701b390893736b557fBf7c2851344f64C,116300,2,2,0,116300,0,58150.0,0,36350.0,0,94500,116300
0x6c29F5fe324d9A9Ebbe867Fafbcc06d0c4a28c6B,1000000,2,0,2,0,1000000,0,500000.0,0,250000.0,750000,0
0xfCa44f58F7135e4E5Fe446c5c6b27ce4Cc6757F8,123250000,1,1,0,123250000,0,123250000.0,0,0.0,0,123250000,123250000
0x4fCA2Ad1cc751d0b4C270Dd10741d0994492908C,55657,2,2,0,55657,0,27828.5,0,9169.5,0,36998,55657
0x8D4293a36c3943FDeFc540D6D4ee73fa7A2034a6,2144,1,1,0,2144,0,2144.0,0,0.0,0,2144,2144
0x2acaB200C5BB5DF231138AE00d6FCdD4d8D82a7e,542522,2,2,0,542522,0,271261.0,0,16780.0,0,288041,542522
0x20A3A4AE2aACB8BbCFd89dc71280DD18cD9a0Cb4,212999512,204,136,68,122318102,90681410,899397.8088235294,1333550.1470588236,2624187.3465207242,5810324.126043573,48000000,31636692
0x26205F2175e0BeD0DCD5a51c6b085868C5fb72Fb,24218,1,1,0,24218,0,24218.0,0,0.0,0,24218,24218
0x49C0F6BA269c549f0A55621f691636072e48dFb6,1500000,2,1,1,750000,750000,750000.0,750000.0,0.0,0.0,750000,0
0x77f33dA6046A03EBB0e6D33A26Cb49bD738774ff,25000,1,0,1,0,25000,0,25000.0,0,0.0,25000,8259924
0xDbefB887662Ca19CD485381F3386fe5F8537B910,8800160000,11,5,6,4400085000,4400075000,880017000.0,733345833.3333334,1759991500.009588,1213344093.5827475,4400000000,10000
0x97f991971a37D4Ca58064e6a98FC563F03A71E5c,4400035000,3,0,3,0,4400035000,0,1466678333.3333333,0,2074171641.9104655,4400000000,4981105611
0xF02e86D9E0eFd57aD034FaF52201B79917fE0713,25000,1,0,1,0,25000,0,25000.0,0,0.0,25000,253593492
0x7f8233997Bd34846978CA36d7c9C88B635c3af5d,7818358000,21,11,10,3909179000,3909179000,355379909.09090906,390917900.0,194559761.22819835,166575550.37186578,600000000,0
0xF13aD4D4255Be66C0dd265a9B3c528e2dd79B279,1800002000,5,3,2,900001000,900001000,300000333.3333333,450000500.0,216024227.03689715,50000500.0,500001000,0
0x18D1E27b8C98Daa392309fb7B6c3c5a56DE320Fb,54769800,22,11,11,27384900,27384900,2489536.3636363638,2489536.3636363638,322830.2882960679,322830.2882960679,2714400,0
0x1A970d87Cd7B4b6b05D769FCecAd68aE6549db07,101245,1,1,0,101245,0,101245.0,0,0.0,0,101245,101245
0xA612D8b7A70b51DEB17D4D10e88e2c58e93b21CE,7298,1,1,0,7298,0,7298.0,0,0.0,0,7298,7298
0xDBF5E9c5206d0dB70a90108bf936DA60221dC080,7618338000,14,4,10,3809169000,3809169000,952292250.0,380916900.0,1423017621.6038885,162682309.44540343,3400000000,0
0x427BcC9Aa374E846EBb2E9E01B9576453074F931,29600,2,1,1,14800,14800,14800.0,14800.0,0.0,0.0,14800,0
0xB3d9a19b130b9354AA60d8631299D342359D6E99,21560,1,0,1,0,21560,0,21560.0,0,0.0,21560,0
0xECE2682AcAeF5b9Cfe4be217C0Eb3Cab4135e1af,14872,1,0,1,0,14872,0,14872.0,0,0.0,14872,0
0x5b295bA8bD4bD502CE0babcf21B74288d3997f00,13819,1,0,1,0,13819,0,13819.0,0,0.0,13819,0
0xb0C9c5afc03a7Aea3B7425A4D6571F3E81C7a4f7,20186000,5,5,0,20186000,0,4037200.0,0,5413995.664571593,0,13626200,20186000
0xF41fCbc9036e5c84090eBAD3660E567e480d99A7,40000,2,1,1,20000,20000,20000.0,20000.0,0.0,0.0,20000,0
0x18F769bBe80DBEC50bF3a65638D0b89B990f0efa,37991834,6,3,3,18995917,18995917,6331972.333333333,6331972.333333333,942747.5141543584,942747.5141543584,7000000,0
0xcF97df5E182A328524059c4032B7d2287F558119,4000000,2,1,1,2000000,2000000,2000000.0,2000000.0,0.0,0.0,2000000,0
0x6133de401FB609aACB767D8b379157731a09b66b,69299670,34,17,17,34649835,34649835,2038225.5882352942,2038225.5882352942,189301.3679643741,189301.3679643741,2793880,0
0xa1B7fAedC187658D0b418abBac90147d2C6192dC,5839,1,0,1,0,5839,0,5839.0,0,0.0,5839,0
0xE28E7a1f0B07B00BDcF39fe35aBcAd4D8f139817,710394,2,0,2,0,710394,0,355197.0,0,22072.0,377269,7130783
0x695Bf7C07c76A1e7F317853567115082f2CA44C6,11196117,1,0,1,0,11196117,0,11196117.0,0,0.0,11196117,0
0x48Dbd04Fec8e179d8aA3Aa809ca794897571BED6,11196117,1,1,0,11196117,0,11196117.0,0,0.0,0,11196117,11196117
0x377737b063439E3AC0E088961d08e6cF0BFD3A03,24773,1,1,0,24773,0,24773.0,0,0.0,0,24773,24773
0x72509cfa1476BA9daD4552AD22ae3EFD1806C24b,93254,2,1,1,46627,46627,46627.0,46627.0,0.0,0.0,46627,0
0xe3456aed6FB7Dfc4CD7596328C08B04262faC20B,557220,6,3,3,278610,278610,92870.0,92870.0,0.0,0.0,92870,0
0xf9DED9f5508b361dc48Ba21Bc70412d9AC272087,93254,2,1,1,46627,46627,46627.0,46627.0,0.0,0.0,46627,0
0x2d1F6192F3837a232522Fd82ef0CD2833e691150,2014670,4,4,0,2014670,0,503667.5,0,492832.97729174944,0,996500,2014670
0xB8c8836ecFaF9a23694a297B693e3fd565e42418,13732,1,0,1,0,13732,0,13732.0,0,0.0,13732,0
0x84cd82C94C63286AA209FD9903F7fD9647d7c5E4,8717,1,0,1,0,8717,0,8717.0,0,0.0,8717,0
0xE2095423345d7D931360644d7691110693D72be7,8051,1,0,1,0,8051,0,8051.0,0,0.0,8051,0
0xb37cc372Ec85120810B87758f9206ba327aBf64A,10564,1,0,1,0,10564,0,10564.0,0,0.0,10564,0
0xb107384A0CB5591209426Cdad280376f0Cb90233,10564,1,1,0,10564,0,10564.0,0,0.0,0,10564,10564
0x815e636C7c06daE00fDBc8D5f96583D8C2888b7a,10000,1,0,1,0,10000,0,10000.0,0,0.0,10000,0
0x0d67219bb3dB4008bC1da921a10200a90159386D,624,1,1,0,624,0,624.0,0,0.0,0,624,624
0x250C3633D4Dd25891F9264EE4590FD3Ab25B8F0C,2401,1,1,0,2401,0,2401.0,0,0.0,0,2401,2401
0xcbCE2347eF6169CbD61895d1B387F4EA7c248782,9841,1,1,0,9841,0,9841.0,0,0.0,0,9841,9841
0xd771487EeE560Fa21Ce1064ef63e52558cE22262,10000,1,0,1,0,10000,0,10000.0,0,0.0,10000,0
0xCAc04F3B6B3882F3c68FcED204e82c2e751c0A8d,4904,1,1,0,4904,0,4904.0,0,0.0,0,4904,4904
0x3B6E30E5F4172d3B7E8100e7a9B50601E1d740fC,52408,2,2,0,52408,0,26204.0,0,11317.0,0,37521,52408
0x45CEe5deCBd2840A5881534b2D07afE7f67c5705,3772700,12,10,2,2139623,1633077,213962.3,816538.5,66331.87667939148,149568.5,966107,506546
0x1F4BC3bCFCDD17936adc35d38e919aa66f11A229,201330,1,1,0,201330,0,201330.0,0,0.0,0,201330,201330
0xaDc1dE16297649D5BcE82A7EF38c3F070AC388fC,6495282,2,1,1,3247641,3247641,3247641.0,3247641.0,0.0,0.0,3247641,0
0x52bF88a34Ef745cA8bD3b86931b8dB2AEE4F9413,154520,1,1,0,154520,0,154520.0,0,0.0,0,154520,154520
0x7A016c5A907580DF4206168e9C6272827C0eb9DE,18879704,2,1,1,9439852,9439852,9439852.0,9439852.0,0.0,0.0,9439852,0
0x14aca12a93E69dfE13f2FBAF2a2235E3eeb5e520,18972254,2,1,1,9486127,9486127,9486127.0,9486127.0,0.0,0.0,9486127,0
0xf76c1C8CCEEa5725b9BBc09B6455d5d3e0ba9619,15668,2,1,1,7834,7834,7834.0,7834.0,0.0,0.0,7834,0
0xaa841Ef1FB5173fBcB93C9BA55B926240d26a18C,2740000000,18,9,9,1370000000,1370000000,152222222.2222222,152222222.2222222,133896956.88001424,133896956.88001424,500000000,0
0x1cB4c7F2ED170846aa1dBd2f88A6e3263ee7251C,251339,1,1,0,251339,0,251339.0,0,0.0,0,251339,251339
0x5874C6f24062566949D440932D64cF0916342733,3932,1,1,0,3932,0,3932.0,0,0.0,0,3932,3932
0xEb99b8106b3179845bAB54d42C9eF99C0338dF8a,49123438,8,5,3,40726000,8397438,8145200.0,2799146.0,10000284.147781441,2671376.991983473,27426741,32328562
0x3cF67EB2870d36713828F35D1d7071E1E5927F91,16794876,5,3,2,8397438,8397438,2799146.0,4198719.0,2671376.991983473,2198719.0,6397438,0
0xA7DA510E6bB43A95De38dB840167EBbAd95226B8,9545048,2,1,1,4772524,4772524,4772524.0,4772524.0,0.0,0.0,4772524,0
0x9036B1eB7630d9A45720FD80D05D46262f460529,1769959,1,0,1,0,1769959,0,1769959.0,0,0.0,1769959,0
0xbB4D1DC5c1ABec4Ea11166ec97E714862863aD1D,1769959,1,1,0,1769959,0,1769959.0,0,0.0,0,1769959,2773451
0xAf32478Bca9C11f43F209ac8E9e4EFC7D7B3B445,6491526,2,1,1,3245763,3245763,3245763.0,3245763.0,0.0,0.0,3245763,0
0x384716Ba139C4e6c47f3e061322fDA8BC62349D1,1105024,1,0,1,0,1105024,0,1105024.0,0,0.0,1105024,0
0x1E263082d795e643EdEC569CCC96b4E836fAFcd8,1105024,1,1,0,1105024,0,1105024.0,0,0.0,0,1105024,1105024
0x8ba2a13e72Fa2d1c6c389Eca61aa4A80C70005d0,55070,1,0,1,0,55070,0,55070.0,0,0.0,55070,0
0x9b3A04828DD56c751430e773cd13aDD39c85D82F,199070,2,1,1,99535,99535,99535.0,99535.0,0.0,0.0,99535,0
0xfE4f6dC7199EfFa22e088EF3C8CD200465A6b3A0,20032164,4,2,2,10016082,10016082,5008041.0,5008041.0,3051.0,3051.0,5011092,0
0x95Beb6fcE6bD5A8455e51c167fc47222fD52f219,4941,1,1,0,4941,0,4941.0,0,0.0,0,4941,4941
0x5284e1b2C45475Df7D39ab03558672f83224E669,142600,2,1,1,71300,71300,71300.0,71300.0,0.0,0.0,71300,0
0x7BC0834c1a9B5dF1088b773ba88D9DeBe4374bE5,18879704,2,1,1,9439852,9439852,9439852.0,9439852.0,0.0,0.0,9439852,0
0xBf9E8E012E9b5414639f90F3BF30aC4CB14e8d28,18972254,2,1,1,9486127,9486127,9486127.0,9486127.0,0.0,0.0,9486127,0
0x42f83497ECBA1608bBfeea9ef1a42e5D9C8064fC,986680,3,2,1,493340,493340,246670.0,493340.0,50000.0,0.0,493340,0
0x8C1B20C8ba191fBcD7e4a554a163DDB3832EBD7f,1566680,3,2,1,783340,783340,391670.0,783340.0,135000.0,0.0,783340,0
0x052A6e2e7Ac259fea1ca6C2A8cE048d0A1D55621,1236286,7,4,3,618143,618143,154535.75,206047.66666666666,37352.17141194739,27069.787172335793,242880,0
0x4417eEFEcadbd70935601960578657c697a90ff1,2038724,2,1,1,1019362,1019362,1019362.0,1019362.0,0.0,0.0,1019362,0
0x6CF8c5290995d9079FBC644CE994178D197860c5,483327,2,1,1,241664,241663,241664.0,241663.0,0.0,0.0,241664,1
0x4a55942698Af6B3707c34c578622F941accd01EA,8801,2,0,2,0,8801,0,4400.5,0,3080.5,7481,0
0xf672775e124E66f8cC3FB584ed739120d32bBaad,1320,1,1,0,1320,0,1320.0,0,0.0,0,1320,1320
0x0B4681eD90C94ABAb0A53bA0b127bf4227b3A1bD,7481,1,1,0,7481,0,7481.0,0,0.0,0,7481,7481
0x59FfCc15f08F84Da2c55d865f19095d478284FdA,70000,2,1,1,35000,35000,35000.0,35000.0,0.0,0.0,35000,0
0xE59f21d8BE577cD361c4e22Fb2Fe153eB128221e,10887,1,1,0,10887,0,10887.0,0,0.0,0,10887,10887
0x4711Fd7f2e9Ebfd29Ab85e55BCc426Ac9C16Bd49,26860,2,1,1,13430,13430,13430.0,13430.0,0.0,0.0,13430,0
0x40ad51171A2a9f055DDFd9ec77E8AB87F1a5f820,13430,1,1,0,13430,0,13430.0,0,0.0,0,13430,13430
0xDFB0e22Ea76920Dd448A5f1020e11117f7251CAD,9734646,3,1,2,3244882,6489764,3244882.0,3244882.0,0.0,0.0,3244882,0
0x6b1AF293236085f727cE4646d41bcD2bC269f60e,18316,2,1,1,9158,9158,9158.0,9158.0,0.0,0.0,9158,0
0xDEFeE6D752DCc9353EeB952a3332ed6Ea0761Af7,5085118,6,3,3,2542559,2542559,847519.6666666666,847519.6666666666,327482.219527853,327482.219527853,1150000,0
0x2a0B82b8B19830625dA8E131945F24086bde2F0f,210000000,6,3,3,105000000,105000000,35000000.0,35000000.0,10801234.497346435,10801234.497346435,50000000,0
0xfE03EC3647BF6f709A2BBC1611D42aDFc2EB9933,2672869,1,1,0,2672869,0,2672869.0,0,0.0,0,2672869,4786960
0x6Ec2C51fE35BE24bD83A5161435b23027dA2e772,12448,1,1,0,12448,0,12448.0,0,0.0,0,12448,12448
0x6B2555F39B1766112Bf511d709155e1bb5607B23,825,1,1,0,825,0,825.0,0,0.0,0,825,825
0xbc3e23386D1d78d6ADB65726783cDa9Eb7460bc3,4899,1,1,0,4899,0,4899.0,0,0.0,0,4899,4899
0x009855F6Dd86431f2313Dcd6d9e17d956a8a8894,344644,4,2,2,172322,172322,86161.0,86161.0,47871.0,51922.0,138083,0
0x0bc58BfB0d7545799BD74f8be1379f5925Dfa6c6,18102,1,1,0,18102,0,18102.0,0,0.0,0,18102,18102
0xf9b35626AE6A1940F4310145B28b2F72e4098057,2840434772,5,5,0,2840434772,0,568086954.4,0,731736260.9246933,0,1778717657,38183771019
0x560672a7d42BE0d47aF7C24a935EA36364c43fE6,2612188,4,2,2,1306094,1306094,653047.0,653047.0,324833.0,324833.0,977880,0
0x7b1707E56b6d23e541EcC005c64eF4AA8e4f3b6e,344644,3,2,1,172322,172322,86161.0,172322.0,51922.0,0.0,172322,0
0xbAf3060503C27b91705564E5eB3bBD646e9e4efC,23620814,4,3,1,11810407,11810407,3936802.3333333335,11810407.0,2713964.1709826523,0.0,11810407,0
0x7dA6e1cBb74FA57e9E0696147A90efB3D928210F,656428,2,1,1,328214,328214,328214.0,328214.0,0.0,0.0,328214,0
0x98DebD798afbC0641B3AA0AdE7443BC8B619261E,12692999,10,0,10,0,12692999,0,1269299.9,0,474870.8511375382,2500000,0
0xb14d7AC1c7c58C7Bb5A0CBbF761C518E9559A868,10891428,2,1,1,5445714,5445714,5445714.0,5445714.0,0.0,0.0,5445714,0
0x8aFDf228AA897626cc986A9db9626FC932F233A6,27500,1,1,0,27500,0,27500.0,0,0.0,0,27500,27500
0xaA2A25A1A7bE90F3A56D1401420D2Ef2c819bB9F,122818,4,3,1,61409,61409,20469.666666666668,61409.0,7426.267897732272,0.0,61409,0
0x52Bf5e519033107C49825BA6c7603D94ca4776Fc,13674852,9,2,7,6837426,6837426,3418713.0,976775.1428571428,1197424.0,883916.7938395282,4616137,0
0x2020d7DB351066a51Ce44D197c21609De0306022,4322,1,1,0,4322,0,4322.0,0,0.0,0,4322,4322
0x1A07e6BCfbf312CF270e1ca433d5d68ff71ED3E4,170080,5,4,1,108829,61251,27207.25,61251.0,4680.093822510399,0.0,61251,47578
0xEB1A6F9ee58C702789c5288FB674E5175AD9c423,2970818,6,3,3,1485409,1485409,495136.3333333333,495136.3333333333,349930.0935637796,324604.3408719127,990000,0
0x34B1227CAC3a71a434678e4e4Ed733dDc2921326,15817,1,1,0,15817,0,15817.0,0,0.0,0,15817,15817
0xeBD295f13459bC80645c6F249b80591dc23704cD,2224,1,1,0,2224,0,2224.0,0,0.0,0,2224,2224
0x64b52E0AfcDa5beB0D7021FF27019d53a84b38f0,137408,3,2,1,131269,6139,65634.5,6139.0,59495.5,0.0,125130,125130
0xB842b3082F3023B1B6C462AD4795F47833a36476,21590,1,1,0,21590,0,21590.0,0,0.0,0,21590,21590
0x89e62cAeAA85126ae16587E94b703De4b9b6074B,12278,2,1,1,6139,6139,6139.0,6139.0,0.0,0.0,6139,0
0xdF4e1AA9478E76fA5dbF90D88D5cdbF035a3C1d0,13498,2,1,1,6749,6749,6749.0,6749.0,0.0,0.0,6749,0
0x80713f1fE2b670cF5e6649d9B20e94490C08B99e,296290,2,1,1,148145,148145,148145.0,148145.0,0.0,0.0,148145,0
0x7e925C8c0Cd0da6D80e611611148D54175CDb639,1723930,2,1,1,861965,861965,861965.0,861965.0,0.0,0.0,861965,0
0x3a0cA7dBe248eF8Ce5Ed2237cE85C7aE6036513A,13952717,1,0,1,0,13952717,0,13952717.0,0,0.0,13952717,0
0x7df3B7f51fBCf048ACb48085Dd943D03dEd86F0B,27905434,2,1,1,13952717,13952717,13952717.0,13952717.0,0.0,0.0,13952717,0
0xA935D55e6B5461Cfec85aFF4Ccc64277B1877355,1719870,2,1,1,859935,859935,859935.0,859935.0,0.0,0.0,859935,0
0xd7F9DD59b6AAa86FEB64547e7c203e834cD3D0E7,47536,2,1,1,23768,23768,23768.0,23768.0,0.0,0.0,23768,0
0x918bACF9f0483bB2c3357B8D1Da79A0B464d5849,9921,2,1,1,4961,4960,4961.0,4960.0,0.0,0.0,4961,1
0xb1d892752d93e06cf045Fc8729a6AE90ED5bBD8c,6733932,15,5,10,6481932,252000,1296386.4,25200.0,583566.7905851394,17588.632692736523,2093434,6229932
0xbb46aE21eAC9902e6D9A7f4d4F1dB5Cc3dB2b504,231624,2,1,1,115812,115812,115812.0,115812.0,0.0,0.0,115812,0
0xeE99Bc4C57f8a79A253c9eD12F08F6cB7e2Adc99,95546,2,1,1,47773,47773,47773.0,47773.0,0.0,0.0,47773,0
0xa5d4B524c7B7741dcD333625Bea0F926FeF393bf,181572,2,1,1,90786,90786,90786.0,90786.0,0.0,0.0,90786,0
0x5B976CA4AC06E404FE3bC301718158dD2c6b934a,95546,2,1,1,47773,47773,47773.0,47773.0,0.0,0.0,47773,0
0x41d28F2b3C460484be9Cf45f4b460c298a803b9B,148238,2,1,1,74119,74119,74119.0,74119.0,0.0,0.0,74119,0
0x86eBF2B0977acb75c08CA98949855b85b9CC1a02,74119,1,1,0,74119,0,74119.0,0,0.0,0,74119,74119
0x882fa7eD3262891e79f5daAdaBe94089f7f2db2C,45502824,3,0,3,0,45502824,0,15167608.0,0,11194209.305262282,30741409,0
0x04B930567340E1CF7fEeCA84628d6FD2C4C3ADA6,9838804,2,1,1,4919402,4919402,4919402.0,4919402.0,0.0,0.0,4919402,0
0xc566940cF6ddbF6836185A6Ba9eDf2c00E84d362,119020,4,4,0,119020,0,29755.0,0,36105.05506850807,0,91255,119020
0xAc6aCe21cd8043eE76B790d8B2686E4Af6807c90,91002304,6,3,3,45501152,45501152,15167050.666666666,15167050.666666666,11194719.555436969,11194719.555436969,30741409,0
0x70184cEFA88e8D768a807078e2eB792475a97114,34144,1,0,1,0,34144,0,34144.0,0,0.0,34144,0
0x3c2e15d7CEE249B99C7dD09dFfB522023dbdf435,116179,2,1,1,34144,82035,34144.0,82035.0,0.0,0.0,82035,0
0x1F46475879806d96e1aBf13340b2878C7D501C00,1000000,1,1,0,1000000,0,1000000.0,0,0.0,0,1000000,1000000
0xa3b83A197F9bCA1E83063bA7A1e9D1314d0fA661,39999,1,1,0,39999,0,39999.0,0,0.0,0,39999,39999
0x83bea6d387DD4a82C2fbB71dFc2d0e292900F7f9,23620814,2,1,1,11810407,11810407,11810407.0,11810407.0,0.0,0.0,11810407,0
0x2D649Df17A5C10138B1FF9539C043DB4Af5f43ac,2069676,2,1,1,1034838,1034838,1034838.0,1034838.0,0.0,0.0,1034838,0
0xcd7de49E95D345e882eFbad344e0D2C8CB32BB65,1034838,1,1,0,1034838,0,1034838.0,0,0.0,0,1034838,1034838
0xaD91a64183C3efa3451DD0340D54d58B20118656,10765,1,1,0,10765,0,10765.0,0,0.0,0,10765,10765
0xC7E47A4089B0e502E2B1dBC178142B59bAc557b9,91019,1,0,1,0,91019,0,91019.0,0,0.0,91019,0
0xE7102fa9c22828D0f4dF3E6d29144Ed578D3697f,182038,2,1,1,91019,91019,91019.0,91019.0,0.0,0.0,91019,0
0xE941770F610B0Ec45E27B6E089739030F16d3e6f,7600,1,1,0,7600,0,7600.0,0,0.0,0,7600,7600
0xD130526cC092e17B44acef04ee31b4a7EF5aB4f8,16575,1,1,0,16575,0,16575.0,0,0.0,0,16575,16575
0x317aD47FE17B0Aaa1A8dDA6B456988a00230f20c,10920000,10,5,5,5460000,5460000,1092000.0,1092000.0,561334.1250984123,561334.1250984123,1930000,0
0x5Ac9484AA8bFD158eF848D35F38a82ACa9Cb3CF5,15263600,16,8,8,7631800,7631800,953975.0,953975.0,614891.7054042931,614891.7054042931,1871800,0
0xdD8667B18Dd6c1a81E1402f54B0d65b0Cf100ACF,1224022,2,1,1,612011,612011,612011.0,612011.0,0.0,0.0,612011,0
0x4dcb493750CfAada6cd978a7Ab0e3Fa106E80E2E,4783526,2,1,1,2391763,2391763,2391763.0,2391763.0,0.0,0.0,2391763,0
0x50106459591adcb1a9b765c35aF65FCa4ef7D40F,4783526,2,1,1,2391763,2391763,2391763.0,2391763.0,0.0,0.0,2391763,0
0x50f4b3Bd889B69C3dFE7F41a9661b8D369620014,4608246,4,2,2,2304123,2304123,1152061.5,1152061.5,847941.5,847941.5,2000003,0
0x0fDF8709732D99708cA620db6965fe96824FF7f4,408498,2,1,1,204249,204249,204249.0,204249.0,0.0,0.0,204249,0
0x3444361a8Fc812a8beE25000dBD4F9f2b63c5BBD,204249,1,1,0,204249,0,204249.0,0,0.0,0,204249,204249
0x00000000009E50a7dDb7a7B0e2ee6604fd120E49,30524035,22,11,11,15262459,15261576,1387496.2727272727,1387416.0,749719.0039477326,749576.2633116004,2720918,883
0x4d492200dAafD114781964803f6a999b64Bc87c3,9355365,7,7,0,9355365,0,1336480.7142857143,0,681969.9284530104,0,2324895,9355365
0x3a59A7c50f748b0743221A33921c8F38B1d9E5F8,10949726,2,1,1,5474863,5474863,5474863.0,5474863.0,0.0,0.0,5474863,0
0x9865465A1531cb45EF7Ec4807Bf9f7DbEb3280eF,8916864,2,1,1,4458432,4458432,4458432.0,4458432.0,0.0,0.0,4458432,0
0x34ba5177C38301915a4DDb670D44012DaeB4E39E,2364373,3,3,0,2364373,0,788124.3333333334,0,854001.2017557248,0,1995204,2364373
0x0fDA4Ac09a12C10FAe30E429F4D6b47C9A83c87e,128265526,1,0,1,0,128265526,0,128265526.0,0,0.0,128265526,0
0x3ec721177211Fc6DC9538f82AB5A67570EFCf588,256531052,2,1,1,128265526,128265526,128265526.0,128265526.0,0.0,0.0,128265526,0
0xe51ec92c032B7ad1b894987e5724Fcc790AcE992,21000000,4,2,2,10500000,10500000,5250000.0,5250000.0,3750000.0,3750000.0,9000000,0
0x5d885D7bcA493fCf23b15A22C527D7e695B483aF,20976380,4,2,2,10488190,10488190,5244095.0,5244095.0,3748535.0,3748535.0,8992630,0
0x6588976D05b57AE3485B00e5a9eCC1df15c5a7f8,20976380,4,2,2,10488190,10488190,5244095.0,5244095.0,3748535.0,3748535.0,8992630,0
0x104f7E74a5463Ddf682923D89712E8b1852EaE7d,197764,2,2,0,197764,0,98882.0,0,77415.0,0,176297,197764
0x8074d8B637f0d1Bbe9E1E368f2f2fc3Ce67A7b87,20976380,4,2,2,10488190,10488190,5244095.0,5244095.0,3748535.0,3748535.0,8992630,0
0x9280bF70b5340EE105D2385477eaaE4489120CaD,10314818,2,1,1,5157409,5157409,5157409.0,5157409.0,0.0,0.0,5157409,0
0x6761047A7277a56fD7D81EF5745483efC2523f9f,10314818,3,1,2,5157409,5157409,5157409.0,2578704.5,0.0,1421295.5,5157409,0
0x4F0796e3DdC86976898928d79c9299E18783667E,5020,1,1,0,5020,0,5020.0,0,0.0,0,5020,5020
0xd45E516ac2E4516C199a918c5320149918A586FE,4289474,1,1,0,4289474,0,4289474.0,0,0.0,0,4289474,4289474
0x252890010F5524D6025417Afc451aa3A75268c8C,17561,1,1,0,17561,0,17561.0,0,0.0,0,17561,17561
0x9394C263A950609fF3ADe404F5fB25A0Bd6B59d8,820082,2,1,1,410041,410041,410041.0,410041.0,0.0,0.0,410041,0
0x2df4985f5Be3b85Eb508af94CB25C1C4cb0b52a8,111000,2,1,1,55500,55500,55500.0,55500.0,0.0,0.0,55500,0
0xF35197a5A54ba60A137CB3A70D23fd23Bf5373DE,7207148,2,1,1,3603574,3603574,3603574.0,3603574.0,0.0,0.0,3603574,0
0xFCdc5329956654eF2f4533302B7db751a3F9332f,5203574,2,1,1,3603574,1600000,3603574.0,1600000.0,0.0,0.0,3603574,2003574
0xC2b924d6BFC7dB60529E289BF7fd9B84e03e0104,2675428,3,3,0,2675428,0,891809.3333333334,0,115179.35739918369,0,979809,2675428
0xC2240BA0D2344574666Ca930e874Abe9604a9d7b,1603000,2,1,1,801500,801500,801500.0,801500.0,0.0,0.0,801500,0
0xf94dD57A331a75956564F6a2bA51BFa151e4Ab8C,1237500,1,0,1,0,1237500,0,1237500.0,0,0.0,1237500,0
0x0C827A9651630be28444D9f6ee21D997f2F3D272,5634950,4,3,1,2817475,2817475,939158.3333333334,2817475.0,593765.1544801942,0.0,2817475,0
0x102dC7EabEe28D33585cc2833Be43cf682EE94AA,1469752,1,0,1,0,1469752,0,1469752.0,0,0.0,1469752,0
0x0046d908e6B072672B66E965eadC6f95b9dEC626,110223,1,0,1,0,110223,0,110223.0,0,0.0,110223,0
0xfeb78a7f47b1D4751376fcEDDda99422d4d94861,487594,4,1,3,243797,243797,243797.0,81265.66666666667,0.0,106112.15390121695,243797,0
0xb6ae79AC10c681478F7b7454480e2c8864A84BD5,243797,3,3,0,243797,0,81265.66666666667,0,106112.15390121695,0,231324,243797
0xbd405708d575A5F1e8351536a08c661819c2D27b,48956,1,1,0,48956,0,48956.0,0,0.0,0,48956,48956
0xd8951aC788d6b318235F671B1a79e68cE1b3B265,6431508,3,1,2,3431508,3000000,3431508.0,1500000.0,0.0,500000.0,3431508,431508
0xAae0330856dEd63Df62a0471a567e93533B5f5BD,18786,2,1,1,10722,8064,10722.0,8064.0,0.0,0.0,10722,2658
0xBdd12DA51CD898a039f0410736eCD5B69Bf7309e,389540,2,1,1,194770,194770,194770.0,194770.0,0.0,0.0,194770,0
0x5528D82423d91da8E8FE8066FAb15cc014ebd5e2,3667822,4,1,3,2817475,850347,2817475.0,283449.0,0.0,306069.2075952758,2817475,1967128
0xabC4dD0b5fe6a2C60b09E0007a43b497285918f8,208002,2,1,1,104001,104001,104001.0,104001.0,0.0,0.0,104001,0
0xbA82E2f78cD2dd8FE3E559d9D96bD1aBA9753eF1,559780,2,1,1,279890,279890,279890.0,279890.0,0.0,0.0,279890,0
0xF6d52FB9613DdBD3eaF4DB92d0De4c6E23F347a2,27588231,2,2,0,27588231,0,13794115.5,0,7048018.5,0,20842134,31942669
0xb1b2d032AA2F52347fbcfd08E5C3Cc55216E8404,167386806,116,62,54,83693404,83693402,1349893.6129032257,1549877.8148148148,715781.4573003039,1245456.8241995333,7398635,2
0xFE3c46B88cd6c6151b485edE57402684199Cd31e,767000,2,1,1,383500,383500,383500.0,383500.0,0.0,0.0,383500,0
0x2d47407395F303ed9C6F464ED2437DcD85AAB97B,1930200,2,1,1,965100,965100,965100.0,965100.0,0.0,0.0,965100,0
0xc1123e6D47b8C429A5b26Ce59b761a62D8fe0e1F,1139516,1,1,0,1139516,0,1139516.0,0,0.0,0,1139516,1139516
0x85cfD4c0B7f3146b5fd64b8EdA3E16f2bC73c327,84458,6,3,3,42229,42229,14076.333333333334,14076.333333333334,12284.043317337424,12284.043317337424,30000,0
0xaB9C06534cDbd6687CF2baF2DDD2BA06848EE51C,18128788,13,7,6,9134465,8994323,1304923.5714285714,1499053.8333333333,2031745.4645011765,2109745.2966971644,4522838,140142
0x1Dd9b1dDD48B0221E8a4DE8fBf3B0Da51b60d11b,125097,1,0,1,0,125097,0,125097.0,0,0.0,125097,0
0xBF1BbA8853020a8Fe8b8d53e34e2BCb083C910E9,250194,2,1,1,125097,125097,125097.0,125097.0,0.0,0.0,125097,0
0x6c9Db4019F811d833De03A8435d13bCF6B8C19a1,200000,1,0,1,0,200000,0,200000.0,0,0.0,200000,0
0xF72cAaF45A7B878b82f88Cf56e41af281176D23a,400000,2,1,1,200000,200000,200000.0,200000.0,0.0,0.0,200000,0
0xDc9eaF0e37735F569Bbe5D4BC10D4B2aC7683d40,167714,2,1,1,83857,83857,83857.0,83857.0,0.0,0.0,83857,0
0x23622A65865ac8e515F9F3482dF223424E18758A,500000,1,0,1,0,500000,0,500000.0,0,0.0,500000,0
0x87A265C93D2A92C6EEEC002283bEaEbb4564Fd20,12500,1,1,0,12500,0,12500.0,0,0.0,0,12500,12500
0x78cE6Aa1202195681ca1e7d29Cb82401D5395710,105925,1,1,0,105925,0,105925.0,0,0.0,0,105925,105925
0x2271fe01C366B0575bd8e7e85424D1a13d369093,89801,1,1,0,89801,0,89801.0,0,0.0,0,89801,89801
0x2c199BE1F16eE578590E2B0268BdAe7F083E6226,6776,1,1,0,6776,0,6776.0,0,0.0,0,6776,6776
0xFAE19028DC15043D4955fb4c617d2d06a7E7BF40,27400,1,1,0,27400,0,27400.0,0,0.0,0,27400,27400
0xa73226b7856616EFafA40Dd37Cdd0fa3907001F5,239641,6,5,1,119821,119820,23964.2,119820.0,8579.748746903955,0.0,119820,1
0xB4355cC0c7e55E1d9e8e7e9D81DF5cb4645f3061,1350466,2,0,2,0,1350466,0,675233.0,0,595233.0,1270466,0
0xB8e6C99c9cA7Ae6780534Ba7E4c8B0F400e8AA92,2700932,4,2,2,1350466,1350466,675233.0,675233.0,595233.0,75233.0,1270466,0
0x51060acd3df1E43f7bF4969dA759792a4fCb67Bc,10634458,10,5,5,5317229,5317229,1063445.8,1063445.8,183763.42011553876,183763.42011553876,1230488,0
0xb8401a94bAAb746dAFc5cF342D2CaCA207EC157D,202222,1,0,1,0,202222,0,202222.0,0,0.0,202222,0
0x5045716dbc0CeDC94F6DF7080B0617E8c14AE46E,235017,1,1,0,235017,0,235017.0,0,0.0,0,235017,235017
0x1c29592Fa98e7084705798D64B25E23e981156cd,6000000,4,2,2,3000000,3000000,1500000.0,1500000.0,500000.0,500000.0,2000000,0
0x548DD4FeA67F0aEF9b99a5f59748e9b96E5b2E2B,602815,1,1,0,602815,0,602815.0,0,0.0,0,602815,602815
0x816337d8c5096e5d2aA355A2055Cbb2C068F17B8,3604246,3,2,1,1802123,1802123,901061.5,1802123.0,802974.5,0.0,1802123,0
0x693e161A6EC06f3Ff9B9D49ee721b3039733372b,21710092,2,1,1,10855046,10855046,10855046.0,10855046.0,0.0,0.0,10855046,0
0xF459b5f5490a9ffbbAd567f8Cb972F702Ca53825,151100,2,2,0,151100,0,75550.0,0,11350.0,0,86900,151100
0x1e871606da1eCb94CeCe8cD2b5a06006Ac46c349,1638,2,1,1,819,819,819.0,819.0,0.0,0.0,819,0
0xC1AeE66CF701C0C97Ed67A96B759C37d9739E331,1775690,4,2,2,887845,887845,443922.5,443922.5,341862.5,341862.5,785785,0
0x561164b536ddD2dB199e43e6774e68Ce413Ab0a5,152245310,8,4,4,76122655,76122655,19030663.75,19030663.75,8586843.75383174,8586843.75383174,26931117,0
0xcBa953c3F874502388DA6E2F6dE7C34Ab8B09a26,55927,1,1,0,55927,0,55927.0,0,0.0,0,55927,55927
0x11BdaFE147d7066ebdB4B0018718cD855d8aA1B5,519858,2,1,1,259929,259929,259929.0,259929.0,0.0,0.0,259929,0
0xBdd056cfe422f7Aa5659b27E49322a78036296Fe,100006,1,1,0,100006,0,100006.0,0,0.0,0,100006,100006
0x0e0fDD32537f7AeE8aCf2244f40529e76616DED4,7482,1,1,0,7482,0,7482.0,0,0.0,0,7482,7482
0x37B30ca0D16cB225845bd831E97Ba61a0bA38E0c,5146,1,1,0,5146,0,5146.0,0,0.0,0,5146,5146
0xcD87cf46a2C4B28C9579f508384e1ed7A0a71680,5170869,3,2,1,3779625,1391244,1889812.5,1391244.0,458784.5,0.0,2348597,2388381
0xFE2dEe24923Ee388B85E787ed574DbFCdfD5318D,972520,2,1,1,486260,486260,486260.0,486260.0,0.0,0.0,486260,0
0x7059f1BE5e4c227787e94381065F482c2f253b1D,5000,1,1,0,5000,0,5000.0,0,0.0,0,5000,5000
0xD629D304c1d94F8Bdf186C4f6881228F1c403149,23956,2,1,1,11978,11978,11978.0,11978.0,0.0,0.0,11978,0
0x89E215BF1447891175B4489Dc80695f53279bF18,191932,2,1,1,95966,95966,95966.0,95966.0,0.0,0.0,95966,0
0xedBd462864f33c71F1a2419f668887c9242b9240,116597,2,1,1,96242,20355,96242.0,20355.0,0.0,0.0,96242,96242
0xFfd6871aBFE09635e0672f10Ea5b1B780e5e60aC,20355,1,1,0,20355,0,20355.0,0,0.0,0,20355,20355
0xaD987f79503d497018398a20bD498eC96EFA5d9C,30058,2,1,1,15029,15029,15029.0,15029.0,0.0,0.0,15029,0
0xa26c58132cFD5aff89B1fC865de427F4672Ca254,15029,1,1,0,15029,0,15029.0,0,0.0,0,15029,15029
0x5402ba10E9F06dD2Cc171Fa4239d119BDb1500a7,23956,2,1,1,11978,11978,11978.0,11978.0,0.0,0.0,11978,0
0xC7b0381809C477ce0AA32F18dF5f87a4a226192A,6557902,2,2,0,6557902,0,3278951.0,0,2711049.0,0,5990000,6557902
0x3335aF8906C988bB4eF3B8CBCbb6D6Ef54565D30,645234,4,4,0,645234,0,161308.5,0,189828.6550991446,0,487467,645234
0xED613121003a0565a3C8b6D88dba2c3147B7b593,503400000,4,2,2,251700000,251700000,125850000.0,125850000.0,125849000.0,125840000.0,251699000,0
0x2CA4D3dd2E9eC27136c7a9f4ee08F809f38A4721,8135046,6,2,4,4067523,4067523,2033761.5,1016880.75,2023761.5,713473.429191086,4057523,0
0x822CFC974abD7C101b302d81d226E524708adb28,28484734,3,1,2,14242734,14242000,14242734.0,7121000.0,0.0,1179000.0,14242734,734
0x9bfD83fD42eb9fE8da0bbAf8eFC5f2C699087E5c,9260000,2,1,1,4630000,4630000,4630000.0,4630000.0,0.0,0.0,4630000,0
0x905508FDCB4f5812C804B1fb7b8C9F434cB40a8a,26400,2,1,1,13200,13200,13200.0,13200.0,0.0,0.0,13200,0
0xbDA8f8A5575D0c63cf6be30aC8F28663c3153945,46890,1,0,1,0,46890,0,46890.0,0,0.0,46890,0
0x82Da358a9D0AC2C6a2E05A621eF7b266cF7f0265,200000,2,1,1,100000,100000,100000.0,100000.0,0.0,0.0,100000,0
0x263d0778aD24d1833268Aa97722dB11A05469357,26000000,2,1,1,13000000,13000000,13000000.0,13000000.0,0.0,0.0,13000000,0
0xEB69f2358A16bD8FAE62D90d36a21A370B487439,55500,1,1,0,55500,0,55500.0,0,0.0,0,55500,55500
0x7472F6ce02ba751dBa1C022A6fd735C4E3754887,5582768,5,2,3,2791384,2791384,1395692.0,930461.3333333334,764123.0,1003638.6017912799,2325073,0
0xa8EdF563dc353CECAC11AB30a216a5e2A7b166aC,30012,1,1,0,30012,0,30012.0,0,0.0,0,30012,30012
0x58d238CBd56Cd0b644b1853b2127b382e0096Cb7,820082,2,1,1,410041,410041,410041.0,410041.0,0.0,0.0,410041,0
0xdca170Cf0887Dd154fC1383b8866CAD4361FC9f7,597780,2,0,2,0,597780,0,298890.0,0,200490.0,499380,1334
0x952De2B71c84639341c941b24E8e5A43BD0a4CD7,597780,2,2,0,597780,0,298890.0,0,200490.0,0,499380,597780
0x2402398E886A3AFC0222D298344F2c1cf49465f1,4091458,2,1,1,2045729,2045729,2045729.0,2045729.0,0.0,0.0,2045729,0
0x369A3da2d9bFC797bdc8E7fF52B63e2b01E262D2,21953204,4,2,2,10976602,10976602,5488301.0,5488301.0,0.0,0.0,5488301,0
0x08cD89D82B52D5587Cc58FA4B1878c2F64047634,10976602,2,1,1,5488301,5488301,5488301.0,5488301.0,0.0,0.0,5488301,0
0x698c6eBb7aE747Abde0d870023852F8e2F3d9bE7,642125,5,3,2,628869,13256,209623.0,6628.0,254909.85054459286,3.0,569399,615613
0x4dCaDB6B2B0d87fc4d8066344960889D4fa6f8Ea,2018864,1,1,0,2018864,0,2018864.0,0,0.0,0,2018864,2018864
0xD509Bd9fb94152e889D30085Fb8624b696B3034e,26000000,2,1,1,13000000,13000000,13000000.0,13000000.0,0.0,0.0,13000000,0
0x6CB8a5a70A51b20eAf9AA990986f36610A8b6Be5,86111,2,2,0,86111,0,43055.5,0,16663.5,0,59719,86111
0x0AcD520333A42A541313e535bb0e9F96d0319483,2484734,3,0,3,0,2484734,0,828244.6666666666,0,687339.7430603167,1784734,0
0x581692420128a96E53eD24bAD22C5B4DD216B12a,2484734,3,3,0,2484734,0,828244.6666666666,0,687339.7430603167,0,1784734,2484734
0xc857cC1Ea8edf8c6fb19c9fe41E010bf5A810d25,812972,2,1,1,406486,406486,406486.0,406486.0,0.0,0.0,406486,0
0x4aAfde80f44843736D63089127A5b416C5712a8e,30700,1,1,0,30700,0,30700.0,0,0.0,0,30700,30700
0x25a7941d9c5e477a8E186F5Af08Ed1EaC2993245,207171,1,0,1,0,207171,0,207171.0,0,0.0,207171,0
0x87b6b565e41fC0970F8a092513984404C0B07462,414342,2,1,1,207171,207171,207171.0,207171.0,0.0,0.0,207171,0
0x2D18d11ECD0B816578d17f6b8F2D70a652C59462,8203,1,1,0,8203,0,8203.0,0,0.0,0,8203,8203
0xd40eEd47a41C11834b68055dd5406D2692fbEC9d,8135046,7,4,3,4067523,4067523,1016880.75,1355841.0,713473.429191086,1133938.3762924098,2800000,0
0x97D0dE16e8e535141866277FAb2e27CD7059Df63,519858,2,1,1,259929,259929,259929.0,259929.0,0.0,0.0,259929,0
0x2bBEA2290111F664Ba3175676AEd3F945D95e32C,9782210,1,0,1,0,9782210,0,9782210.0,0,0.0,9782210,0
0x25E43b1166880289a4f5594888EC8820bf2407d8,19564420,6,1,5,9782210,9782210,9782210.0,1956442.0,0.0,1346545.5051560642,9782210,0
0x60dde92C39673A89d2A468735891Efc8Dc48d972,2959560,1,1,0,2959560,0,2959560.0,0,0.0,0,2959560,2959560
0xBBCe6b02dA9902a1cc607B2721fB806e3237d795,19564420,9,5,4,9782210,9782210,1956442.0,2445552.5,1346545.5051560642,1058459.0642857898,4000000,0
0x140d0649B6D8302aCEf38c8d4a0b6F10Bd38b565,269100,1,1,0,269100,0,269100.0,0,0.0,0,269100,269100
0xBbd2C9B1d69634Ce1354aBE320dA8478D374358A,5871800,2,1,1,2935900,2935900,2935900.0,2935900.0,0.0,0.0,2935900,0
0x1A5097B9E4604DC6087714d2f0bA2b485C614a7f,185600,2,1,1,92800,92800,92800.0,92800.0,0.0,0.0,92800,0
0xBB9EF5828a85F8349ea8Ef6549fab463a8670489,97095940,26,13,13,48547970,48547970,3734459.230769231,3734459.230769231,1704807.6679167857,1285330.8289721278,7006036,0
0x30e64c15ADB40EA65642Dc44bD1109C46E983D82,48547970,12,6,6,26778634,21769336,4463105.666666667,3628222.6666666665,781525.8202281113,1856214.2032379296,7006036,5009298
0x1B2D7f79ba7947578fC489afd4B0c0119bccb30b,14658,1,1,0,14658,0,14658.0,0,0.0,0,14658,14658
0xE592427A0AEce92De3Edee1F18E0157C05861564,1518096,2,1,1,759048,759048,759048.0,759048.0,0.0,0.0,759048,0
0xaB72d84aF763a4c7A5B08c93e30f8c6efd4ceD1C,719424,1,0,1,0,719424,0,719424.0,0,0.0,719424,0
0xC47AE79776F552BB99eD75A50Db942FfF337c106,15920842,7,1,6,8550842,7370000,8550842.0,1228333.3333333333,0.0,714619.1681976881,8550842,1180842
0x30BdCe36a7A158EE736536Ac9c324Ca6c1556B35,119901516,10,5,5,59950758,59950758,11990151.6,11990151.6,4793120.97237554,4793120.97237554,16726152,0
0x505A07006Bd8bd0C644A91293C14529597ea61A8,92800,1,1,0,92800,0,92800.0,0,0.0,0,92800,92800
0x12e984eaA6D82874fc5A4D55e3D35E73703263cf,4920,1,1,0,4920,0,4920.0,0,0.0,0,4920,4920
0x98FE27297E539FA426556Ff96f7d00425193e5e6,23768,1,1,0,23768,0,23768.0,0,0.0,0,23768,23768
0x5FcdC32DfC361a32e9d5AB9A384b890C62D0b8AC,529046,1,0,1,0,529046,0,529046.0,0,0.0,529046,0
0x89690819b44A1E124B7C8fE7B962d079dd224dC8,4093274,13,4,9,2046637,2046637,511659.25,227404.11111111112,441315.69879813644,391677.8304815904,1332637,0
0xD5b6005130Aa740dD0461E0b72DfF6C8D5Ea051b,21710092,2,1,1,10855046,10855046,10855046.0,10855046.0,0.0,0.0,10855046,0
0x74b638bad77e4eDD0b9A595883cFA74A70d2b458,3057966,2,1,1,1528983,1528983,1528983.0,1528983.0,0.0,0.0,1528983,0
0x187f0579cbFdA32b341D87cF038F8F81E1fB41EA,10395768,6,3,3,5197884,5197884,1732628.0,1732628.0,899801.2221789135,899801.2221789135,3000000,0
0x5c39773F86F81d7B37292ca128c0097b9d7C0007,26456,4,2,2,13228,13228,6614.0,6614.0,1402.0,1402.0,8016,0
0x1BA2B9dc5e3AA3F61c459a4dd13b293d9F81A156,18440,3,2,1,13228,5212,6614.0,5212.0,1402.0,0.0,8016,8016
0xE7eCB9931Df3322aA0BEDc10f4aEE6419A64e8DF,20872499,7,4,3,10482499,10390000,2620624.75,3463333.3333333335,2913716.2033579536,4685938.777045878,10090000,92499
0x3cAE220c918847074A846FFf654EC11809EAda8C,6545948,5,3,2,3272974,3272974,1090991.3333333333,1636487.0,759849.1450116193,1634487.0,3270974,0
0x06E001b5D4059E3Bcd0895A5f63FDCdE4A73baaf,5212,1,1,0,5212,0,5212.0,0,0.0,0,5212,5212
0xBFeE6363dd7c5836dCe52873F7671D842CEC3777,4333138,1,0,1,0,4333138,0,4333138.0,0,0.0,4333138,0
0x7FfE708b2847f96Bb96619251bD597Fc437777bf,8666276,2,1,1,4333138,4333138,4333138.0,4333138.0,0.0,0.0,4333138,0
0xA924B3B8EbfEF7C40E679e59b214058e875B9b67,4172974,2,1,1,2086487,2086487,2086487.0,2086487.0,0.0,0.0,2086487,0
0x41a4098E98F1Eaa0D1D7Bcb51AC689e85dd40D8a,1780449,1,1,0,1780449,0,1780449.0,0,0.0,0,1780449,1780449
0xeB3b6f555C8f23c1E81bd006c009B6E31C2aad91,103372739,5,5,0,103372739,0,20674547.8,0,10216265.058188524,0,37953469,103372739
0x0d92265493063CbEffE69eF641D411f9417807f1,6818318,2,2,0,6818318,0,3409159.0,0,1912366.0,0,5321525,6818318
0x516519bf79CC936506E0Dc318433c52daCB35cb9,170000,1,1,0,170000,0,170000.0,0,0.0,0,170000,170000
0x3E06Bb360F06501B0C8376F37844406c006daC6C,57232,1,1,0,57232,0,57232.0,0,0.0,0,57232,57232
0xb519deCd6da431Df09995D06aFA5E3b06eFa2513,8849908,8,4,4,4424954,4424954,1106238.5,1106238.5,926220.6235985301,929394.5383163439,2579202,0
0x43E143866599A2E4B38cC8FAd0bFa160C3331EeC,1004628,2,2,0,1004628,0,502314.0,0,58147.0,0,560461,1004628
0x0A05E7Aa1Ca7d45F016115550B4a6a2Bbb1bF6FC,60342,1,0,1,0,60342,0,60342.0,0,0.0,60342,8057
0x51D1E2A939ba1A784d4eC95Efd52BE62a2Aa3717,60342,1,1,0,60342,0,60342.0,0,0.0,0,60342,60342
0x84AA50933E4aeBfC8B9237443B248490AD7EB0A0,19964000,3,2,1,9982000,9982000,4991000.0,9982000.0,4496000.0,0.0,9982000,0
0xC7af98621c59636224851e3593c2694c8bE039B6,643670994,4,2,2,321835497,321835497,160917748.5,160917748.5,160907748.5,160907748.5,321825497,0
0x1157A2076b9bB22a85CC2C162f20fAB3898F4101,643670994,4,2,2,321835497,321835497,160917748.5,160917748.5,160907748.5,160913748.5,321831497,0
0xbfF6aad60C727fd016B66D8eb41083c6F8AeC481,2213532,2,1,1,1743532,470000,1743532.0,470000.0,0.0,0.0,1743532,1273532
0x2a76f4616bE697CFDa0ff6802bE346fE8a59D037,887044,4,2,2,737044,150000,368522.0,75000.0,226187.0,25000.0,594709,587044
0x9b6A470C0865e044A4b821A2398564B83E1F1e69,16113601,4,3,1,8056801,8056800,2685600.3333333335,8056800.0,1364287.0595297099,0.0,8056800,1
0x53FacEe52e897740B140F5304E9Cd9DC6238d735,22327363,16,8,8,11163682,11163681,1395460.25,1395460.125,595726.3393838546,595726.3461629084,2408513,1
0x3F5Aa045f1581BA1894923A2f51a7bE2A67274a8,1993560,2,1,1,996780,996780,996780.0,996780.0,0.0,0.0,996780,0
0xC3C7D9060C310Cb4c3373EADc64f1D9aE936CF38,27097616,10,5,5,13548808,13548808,2709761.6,2709761.6,2205892.819879751,2189139.2528986,4566714,0
0xDF28A044F599c33F0Ba6aF88f5b9895D549803C1,19565346,7,2,5,9782673,9782673,4891336.5,1956534.6,1896169.5,1740339.8984677217,6787506,0
0x51f37E99cf8d0bbeC571287e5Bf9032AB196e58a,153107,1,0,1,0,153107,0,153107.0,0,0.0,153107,944333
0x14feE680690900BA0ccCfC76AD70Fd1b95D10e16,153107,1,1,0,153107,0,153107.0,0,0.0,0,153107,153107
0x94460D8Fbe3eF67f7B13315bF9BDDcB6a99D1822,11724158,11,6,5,5862079,5862079,977013.1666666666,1172415.8,581872.5935109325,358301.23825764266,1545584,0
0x654aB2F02900B120fab63437e53b7e8A9E84177A,10000,2,0,2,0,10000,0,5000.0,0,3500.0,8500,0
0x9b9b5Fb4336C544d80D8de624374efF3A5324254,17000,2,1,1,8500,8500,8500.0,8500.0,0.0,0.0,8500,0
0xc46B8168CE647f825cE72429dD65A2E99a415927,1500,1,1,0,1500,0,1500.0,0,0.0,0,1500,1500
0xc48c44Cd54E986Dae515B3322d124a2b947C3237,4424954,4,4,0,4424954,0,1106238.5,0,929394.5383163439,0,2579202,4424954
0x1c6f8e95c6abcD1EbB534d9d4eD4eFDc0510A16B,8853604,4,2,2,4426802,4426802,2213401.0,2213401.0,243651.0,243651.0,2457052,0
0xf513c2b25b87D98dc1bF52332A83BB3c37FF2425,201972,1,1,0,201972,0,201972.0,0,0.0,0,201972,201972
0x9C2d8f31AF6EB863b32DcBF4F1A124cE07C79fbF,837600,2,1,1,418800,418800,418800.0,418800.0,0.0,0.0,418800,0
0x46A352514159FC60f11Df50B7cE3B8C615C19ce3,847480,1,1,0,847480,0,847480.0,0,0.0,0,847480,847480
0xD8D254C518aBBF990Db81ebeb5d7dCf2b0316B39,607834,1,1,0,607834,0,607834.0,0,0.0,0,607834,607834
0x10b5c6c8fE439f006B5B4B31078b6F563273A617,643670994,3,2,1,321835497,321835497,160917748.5,321835497.0,160913748.5,0.0,321835497,0
0x91E17037DE79987d9C58cB3eE982257Ee2369BE6,10148764,2,2,0,10148764,0,5074382.0,0,641885.0,0,5716267,10148764
0xA2C6654dbF0A7a081c703032B847bfC2431fb66d,1381697,2,2,0,1381697,0,690848.5,0,669463.5,0,1360312,4510799
0xB2673dBA53c40452930137D516304cE06319047B,1279927,2,1,1,804927,475000,804927.0,475000.0,0.0,0.0,804927,329927
0xbb334aB71AD5ce89326e807F11Badac1E15EfB7B,8853604,4,2,2,4426802,4426802,2213401.0,2213401.0,243651.0,243651.0,2457052,0
0x4a02cd5FF6b58D8d834825D4Af396A13D620E48f,3280,1,1,0,3280,0,3280.0,0,0.0,0,3280,3280
0x056dD21f8e99fe48Ef3979757f0d527e2089B783,13256,2,2,0,13256,0,6628.0,0,3.0,0,6631,13256
0x1a91370467888e0cEeF75ab609F374d7a71eC178,550492,2,1,1,275246,275246,275246.0,275246.0,0.0,0.0,275246,0
0xa890b98d2438d161eFfF191c18b6Ea6b68A17ffa,14232076,3,2,1,7116038,7116038,3558019.0,7116038.0,3124889.0,0.0,7116038,0
0x520DEBcD5699FED1c9706Cd2EB33a6453E6d424a,16163430,2,1,1,8081715,8081715,8081715.0,8081715.0,0.0,0.0,8081715,0
0x68B05e4C4Ed7Db769F853384C5369aB090711821,14581002,2,1,1,7290501,7290501,7290501.0,7290501.0,0.0,0.0,7290501,0
0xa1B2A2dFe6300D3f2174e0a4f073Fc0F78F5169F,14580501,2,1,1,7290501,7290000,7290501.0,7290000.0,0.0,0.0,7290501,501
0xfFcb6eB2cDB8FbA75F170d24aA69Be34633D356B,0,1,0,1,0,0,0,0.0,0,0.0,0,0
0xAA476bfB0EF91ac8Aba5C016E7674ea145acB231,0,1,1,0,0,0,0.0,0,0.0,0,0,0
0x42F2e934464D5Cd810880a441Ccc637a4AE202B2,2013214,2,1,1,1006607,1006607,1006607.0,1006607.0,0.0,0.0,1006607,0
0x98C469F84BC62574484b5FCe797831DF897B6195,155836,2,1,1,77918,77918,77918.0,77918.0,0.0,0.0,77918,0
0xCAA54eb6a5B6A8e046007DF95bE3ad218f79d842,81037,1,1,0,81037,0,81037.0,0,0.0,0,81037,81037
0x80Bd957f42648a9339DB30924cc3748a9FE4Db01,357041,1,1,0,357041,0,357041.0,0,0.0,0,357041,357041
0x0137683529B0246B6708fcE510D0A6A385656AeD,14580000,2,1,1,7290000,7290000,7290000.0,7290000.0,0.0,0.0,7290000,0
0x79f30855B246948ce85F45aA77e83C5a6a152402,31329,1,1,0,31329,0,31329.0,0,0.0,0,31329,31329
0xC12Cfac94209928B93C4baD168e5117a6B93cC34,18664,1,1,0,18664,0,18664.0,0,0.0,0,18664,18664
0x533B44Ed23934aDA372740e1cdd87D0bd4409e99,571250,2,1,1,285625,285625,285625.0,285625.0,0.0,0.0,285625,0
0xC8D8A1FF0Dc9FA81f0975540171447205d5B34D5,62938,2,1,1,31469,31469,31469.0,31469.0,0.0,0.0,31469,0
0x185Ab4Bc7794F400f7234A423BF5910F5BcA2570,31469,1,1,0,31469,0,31469.0,0,0.0,0,31469,31469
0xA2839662aD43e6Ad5AC4229c926e0BcC315C3017,99535,1,1,0,99535,0,99535.0,0,0.0,0,99535,99535
0xFd1deE97294666ac566377Cc7c6199D28e48a486,110800,1,1,0,110800,0,110800.0,0,0.0,0,110800,110800
0xAEfCa749D7871E91a18901370D7a092932405daa,3337029,1,1,0,3337029,0,3337029.0,0,0.0,0,3337029,3337029
0x91065f6CAaCf6AAc6303D2B27a0077F45dedCc04,3145319,7,7,0,3145319,0,449331.28571428574,0,326155.8785286194,0,1014996,3145319
0xCF42dDe2c4cc951B21eF46ceb31123aCf8E30c5B,68468,2,1,1,34234,34234,34234.0,34234.0,0.0,0.0,34234,0
0xEb63E68B5ed876574F9F7F4F4F675f26B66F28Eb,6838168,2,2,0,6838168,0,3419084.0,0,232450.0,0,3651534,6838168
0x0c0FBB43F1993d69252ff7C0AC4fA3db3E86631B,8500,1,1,0,8500,0,8500.0,0,0.0,0,8500,8500
0x7d4e7e887546856dBdA5C5387C218A9523610B4b,167714,2,1,1,83857,83857,83857.0,83857.0,0.0,0.0,83857,0
0x8af416370a0FADC31d41D9247b0B4c5bd970Ee4e,5428800,2,1,1,2714400,2714400,2714400.0,2714400.0,0.0,0.0,2714400,0
0xB0000000aa4f00aF1200C8B2BefB6300853F0069,59211082,4,2,2,29605541,29605541,14802770.5,14802770.5,4098567.5,4098567.5,18901338,0
0x1c26c748D5E687f1fa5091E2dBC335fB791D0243,8329177,1,1,0,8329177,0,8329177.0,0,0.0,0,8329177,8329177
0xcf416c7f486701DaFaDa553e4C747083B1fd8dBd,453477,1,1,0,453477,0,453477.0,0,0.0,0,453477,453477
0xC0dA82E01994F45879573665d54e3BFB3C1D679f,68468,2,1,1,34234,34234,34234.0,34234.0,0.0,0.0,34234,0
0x40c071dBF7E561c9611d8A8BaC72124E8B229bA6,19146386,8,4,4,9573193,9573193,2393298.25,2393298.25,1682904.118760688,1682904.118760688,4919540,0
0x401ad104C2966Fd167CC3B5E2E4D2d45F43bF684,91988,1,1,0,91988,0,91988.0,0,0.0,0,91988,91988
0x69e3a0Ff31B3dcbFB242Dc4408f546e0ee89045d,1941348,1,1,0,1941348,0,1941348.0,0,0.0,0,1941348,1941348
0x7575F1811C6F4e772E69e1880678Da370a6D295D,1455656,1,1,0,1455656,0,1455656.0,0,0.0,0,1455656,1455656
0xcCB8f520B834F298A9f43c1e451834c1C0a8759f,1224022,2,1,1,612011,612011,612011.0,612011.0,0.0,0.0,612011,0
0x74856377CE70C652a8BE16eECD83cA1Cec553D28,4551952,4,2,2,2275976,2275976,1137988.0,1137988.0,1091452.0,1091452.0,2229440,0
0x2DE441a8338B1C1e2E0654Ac12FB8aC1E3B6c814,2074830,1,1,0,2074830,0,2074830.0,0,0.0,0,2074830,2074830
0x7A9f0187D0e9BE9340F040CeE1a12E8168fa9B61,5095991,4,4,0,5095991,0,1273997.75,0,1145764.8988410265,0,2468618,5095991
0xfC1c1a7CBBCd3Bc63C22d1C3e84E587413Ec2869,874415,2,2,0,874415,0,437207.5,0,2767.5,0,439975,874415
0xf782EF23D8666Ce2105889717744F01408098399,3000,1,1,0,3000,0,3000.0,0,0.0,0,3000,3000
0x800e9B33B299c1c6De5AdCc4416f33c05C6952BF,1100000,3,0,3,0,1100000,0,366666.6666666667,0,188561.80831641264,500000,100
0x7499134256E17FcaA56cC8Ae703Dfb35a919Eb2D,1000000,2,1,1,500000,500000,500000.0,500000.0,0.0,0.0,500000,0
0xD907D07EBFd3Aa30343C44516A2dfa9D5CAA7DF6,75378,3,2,1,37689,37689,18844.5,37689.0,9686.5,0.0,37689,0
0xE61b7fEe8EBFd367e9924f1a161dB990cc59Cdba,1418412,2,1,1,709206,709206,709206.0,709206.0,0.0,0.0,709206,0
0x33EF47d9d1B636c92f185CB5aa580878d120dB2F,8669470,4,2,2,4334735,4334735,2167367.5,2167367.5,32661.5,31120.5,2200029,0
0x352A3666B27Bb09Aca7B4a71Ed624429B7549551,8000,2,2,0,8000,0,4000.0,0,2688.0,0,6688,8000
0x2E22C8C2b74A2bA9399AcBfA8E383F57301E6Bac,200000,2,1,1,100000,100000,100000.0,100000.0,0.0,0.0,100000,0
0x7117606D69Cec8d5438E39C045708B0a1d0Cf30C,1000000,2,1,1,500000,500000,500000.0,500000.0,0.0,0.0,500000,0
0xD450f87288fAC523f84Be574A9d1BBc660123882,1747834,2,1,1,873917,873917,873917.0,873917.0,0.0,0.0,873917,0
0xda56F3277fD399b4214451BF9b8908973876eA30,121208,1,0,1,0,121208,0,121208.0,0,0.0,121208,0
0xa33b78E87244edC7951e2498Ae358F5831984FFB,2501738,2,1,1,1250869,1250869,1250869.0,1250869.0,0.0,0.0,1250869,0
0xFC101c9b0b315578871AF34F3dd5A4478d8C3596,2049878,5,3,2,1024939,1024939,341646.3333333333,512469.5,232640.6448528622,499825.5,1012295,0
0xbb86f99b61a6fbD9E192aC1aBc2D7b9DedE520ff,589520,2,1,1,294760,294760,294760.0,294760.0,0.0,0.0,294760,0
0xCE38EBe7ae532b2618882A99F967A3AC565D83DA,118082,2,1,1,59041,59041,59041.0,59041.0,0.0,0.0,59041,0
0x170f7Be1bAf9234aF5966d194a0A6Bd6073EEd99,10419,1,1,0,10419,0,10419.0,0,0.0,0,10419,10419
0xEf3bE89f36f77CCff98f4c7360Be9e349AC13c6B,2049878,4,2,2,1024939,1024939,512469.5,512469.5,499825.5,499825.5,1012295,0
0xa1bbc2496Ac657da8Fb45B85eAaF3C965947acdE,249942,1,1,0,249942,0,249942.0,0,0.0,0,249942,249942
0x6395279620a2e5733311D008D245E339AB73241f,17583,1,1,0,17583,0,17583.0,0,0.0,0,17583,17583
0xbEa87905e9aD0EA71dbD4836436858776baaa944,24516,2,1,1,14516,10000,14516.0,10000.0,0.0,0.0,14516,4516
0x1285270c79FD2D3907C163c1F094323fAa28cC3a,155836,2,1,1,77918,77918,77918.0,77918.0,0.0,0.0,77918,0
0x5D4960c818b1DE15bB574789015d2eb8c1282042,312226760,2,2,0,312226760,0,156113380.0,0,155113380.0,0,311226760,312226760
0x9f58465409580bd9dFFD63D7E72447Bc909eEBDf,418960,2,1,1,209480,209480,209480.0,209480.0,0.0,0.0,209480,0
0x3C37003669ABcE84f3db627edAb8F0717276975f,597278,2,1,1,298639,298639,298639.0,298639.0,0.0,0.0,298639,0
0xe43ca1Dee3F0fc1e2df73A0745674545F11A59F5,9829196,4,2,2,4914598,4914598,2457299.0,2457299.0,2398258.0,2398258.0,4855557,0
0xc5098325ee2aBEeC9579E2572d2EE7547baF5af9,276282,2,1,1,138141,138141,138141.0,138141.0,0.0,0.0,138141,0
0xAcF98aF36845EC9AEda29FEEd2907ea287388cF3,356050,3,2,1,178025,178025,89012.5,178025.0,14737.5,0.0,178025,0
0xd8f456638521656B7f6f2dA7BBFb0e35B4F9C188,1613018,8,4,4,806509,806509,201627.25,201627.25,52737.10973486791,35302.35250217045,289415,0
0x51D02887a7Bf1F7B598025F02A6248d43A6f7450,11326168,2,1,1,5663084,5663084,5663084.0,5663084.0,0.0,0.0,5663084,0
0x3e8162c282a29D3a43C76A02D43e1180d36EE316,35894600,18,9,9,17947300,17947300,1994144.4444444445,1994144.4444444445,49.69039949999533,49.69039949999533,1994200,0
0x8E2e464Ed7B789Cca1B3D980927b6077fFAc6Ab0,2277460,5,5,0,2277460,0,455492.0,0,1153.51341561336,0,456751,2277460
0xC37362927Fe05aBA72c533e23f97781eBb0877B7,198706612,18,9,9,99353306,99353306,11039256.222222222,11039256.222222222,6928112.486231406,6928112.486231406,20973327,0
0xdE7e32206BE3810b91d260fC041589372Fc030F0,1943358,2,1,1,971679,971679,971679.0,971679.0,0.0,0.0,971679,0
0x419694802635D0686987d38Ab7B7DF13e785d641,187143,1,0,1,0,187143,0,187143.0,0,0.0,187143,0
0x3106D2CaaAACbf88f2Fc90B0e9431b79fAE7e075,187143,1,1,0,187143,0,187143.0,0,0.0,0,187143,187143
0x0d82ABDcF6558fa2680Dfc276b8122eabf6c0E76,20070734,3,2,1,10035367,10035367,5017683.5,10035367.0,2046793.5,0.0,10035367,0
0x997557EfcEB082D8A992E29BB28E31D9183B2A08,81400,2,1,1,40700,40700,40700.0,40700.0,0.0,0.0,40700,0
0xd8260A1943f1Dac9E746F4be0D84933CcDb6ff76,3981608,3,2,1,1990804,1990804,995402.0,1990804.0,135.0,0.0,1990804,0
0x1a32B4c42CFC93f70924A93f35a54A54193C316c,465092,2,1,1,232546,232546,232546.0,232546.0,0.0,0.0,232546,0
0xe941E860296681378DbFc3c3820aCbd3B3a48dcC,11488,1,1,0,11488,0,11488.0,0,0.0,0,11488,11488
0xe18147E1fC48b08EE5179c277B4110E0B36eEfF7,15694,1,1,0,15694,0,15694.0,0,0.0,0,15694,15694
0xbAeD5A2E8a9c3f2DaA7332a90FEa69F775Ba9C80,2339429,1,0,1,0,2339429,0,2339429.0,0,0.0,2339429,0
0x178bDe9b4EDf80bb93aA76F20D8A4acF0Ac520e8,2791384,3,3,0,2791384,0,930461.3333333334,0,1003638.6017912799,0,2325073,2791384
0x90e1fe7b5757639E3341F3dC5dcb94DDDB2494db,1052518,2,1,1,526259,526259,526259.0,526259.0,0.0,0.0,526259,0
0xeb0D4Fac0fa76020315cf46C717667a70b957E14,24600,2,1,1,12300,12300,12300.0,12300.0,0.0,0.0,12300,0
0xD0DbcbD2E021638d74Cb7898FD949A79ddDF17Ad,10676,2,1,1,5338,5338,5338.0,5338.0,0.0,0.0,5338,0
0x3f32f4261506f74dF46677834710Cb3fC2f1F5c7,18228312,3,2,1,9114156,9114156,4557078.0,9114156.0,2086561.0,0.0,9114156,0
0x2dfaDAB8266483beD9Fd9A292Ce56596a2D1378D,1368460,2,1,1,684230,684230,684230.0,684230.0,0.0,0.0,684230,0
0x115843980BFDa9860cF0344bb6717543a9a532A8,684230,1,1,0,684230,0,684230.0,0,0.0,0,684230,684230
0x90Bc84BEFC93c7239E5Ec9748361E6fB18d1Ba36,2539003,6,6,0,2539003,0,423167.1666666667,0,20085.152994327815,0,457261,2539003
0x48e622ba00E9901b584DFEa0bd63B6aEd114B926,62314,2,2,0,62314,0,31157.0,0,2261.0,0,33418,62314
0x089B5943bcdC04c93fA85d52C238Db1FeA38a44e,24431354,3,3,0,24431354,0,8143784.666666667,0,5314181.610170866,0,13737896,24431354
0xF8eE3C31281e7B0E1354a19F45c5Fe2FF7d77Bd9,10000,1,1,0,10000,0,10000.0,0,0.0,0,10000,10000
0x7d51760ceB7E4035D2b361cB98AD88CB14392f11,46180,1,1,0,46180,0,46180.0,0,0.0,0,46180,46180
0x8D8Ca6fF2Bc7CDb317F3e558F27e257D71A0b194,1560000,3,2,1,1530000,30000,765000.0,30000.0,735000.0,0.0,1500000,1500000
0xA7a9aFC34626829AF7624E9C9894f12954d8bcD5,31000,2,1,1,30000,1000,30000.0,1000.0,0.0,0.0,30000,29000
0xe673A44B4B0D7bc06A05FFe59b4363ea25E61855,1377836,2,1,1,688918,688918,688918.0,688918.0,0.0,0.0,688918,0
0x894b87dfB9e79082d2D0Ac7c16cE40658afd42D1,8783709,1,1,0,8783709,0,8783709.0,0,0.0,0,8783709,8783709
0x74EEF153E7B643A9bC43Ab777c635e8e6379dEEc,689894,2,2,0,689894,0,344947.0,0,303878.0,0,648825,689894
0x2835958357d395b5D25615753467F4Aa89B0599c,1128063,5,4,1,690563,437500,172640.75,437500.0,155594.06174300966,0.0,439219,253063
0x3bCC86e031c9f4011802D40D469D6d499c49C916,2000,2,1,1,1000,1000,1000.0,1000.0,0.0,0.0,1000,0
0xB4FF725b6d64f10aA25Ed5931Bc4CFbe16B27766,2188226,2,1,1,1094113,1094113,1094113.0,1094113.0,0.0,0.0,1094113,0
0xADBF30F9481E7aF2ccCBca0FcD37C0f9F3156E7F,2159894,2,1,1,1079947,1079947,1079947.0,1079947.0,0.0,0.0,1079947,0
0x0c92C522b0A492829C17ba4976B413F7e752A3EE,1000,1,1,0,1000,0,1000.0,0,0.0,0,1000,1000
0x937009EDD50E38f287F660E44FE7144e318a87E2,964875,1,1,0,964875,0,964875.0,0,0.0,0,964875,964875
0xA94e77b21d18De025115C36C2F2b5b15d7c9679B,20000,2,1,1,10000,10000,10000.0,10000.0,0.0,0.0,10000,0
0x3b80244D5f213Fa1Ac5acc36C2Cb0bb0d5aA5E79,10000,1,1,0,10000,0,10000.0,0,0.0,0,10000,10000
0xaa3Cf4A9Bb743f5cB307Fe2c2C8196280bE48CED,28367914,12,6,6,14183957,14183957,2363992.8333333335,2363992.8333333335,413046.1193258434,413046.1193258434,2802800,0
0xC33643bd0DeB2CA03dFB44b5312F38Abe3d6C4BE,45462,1,1,0,45462,0,45462.0,0,0.0,0,45462,45462
0x312E263e3cD560602607271a118a3861E5e68eeB,54554,1,1,0,54554,0,54554.0,0,0.0,0,54554,54554
0x632B41DEeE2abc0F861f31Db9116B65a1feDacF4,2089142,1,1,0,2089142,0,2089142.0,0,0.0,0,2089142,2089142
0x35F0B2fdBB6B3caaD2E7869221c54E23a76ED35c,13030278,20,4,16,6515139,6515139,1628784.75,407196.1875,302073.14496192394,279286.91749015445,2141999,0
0x4d39a1758e3f5008123F81D4c1d2fbAA6Ee27Aae,1950422,5,4,1,975211,975211,243802.75,975211.0,149345.2120731947,0.0,975211,0
0xe33465DC2BA48823039A8e83bAe43275e4473400,272450,3,3,0,272450,0,90816.66666666667,0,37461.196006297265,0,134074,272450
0xb0Aa9DfDb8fd43D4FC435031A859CF2acd35233a,4584,2,2,0,4584,0,2292.0,0,157.0,0,2449,4584
0x13d4C58FdB1d2871f0EAB42c3f8Ddb45e0281d62,44947,1,1,0,44947,0,44947.0,0,0.0,0,44947,44947
0xA8B0B631fC279d38319B5EdCFb8CC0b2498Bd734,964657,1,1,0,964657,0,964657.0,0,0.0,0,964657,964657
0x00368bC7B7dFe7d5638ba5ffC9F9d723Df682F1c,870769,2,2,0,870769,0,435384.5,0,11985.5,0,447370,870769
0x8854eeE5756A310238a25dB94D9aCb8CD92fdB55,3604246,2,1,1,1802123,1802123,1802123.0,1802123.0,0.0,0.0,1802123,0
0xa8F39AEE8A615b59D20B6Dc9e1Dd9527f4398B7b,3666688,3,2,1,1833344,1833344,916672.0,1833344.0,906672.0,0.0,1833344,0
0x58Ed2c3D05f0c31d9a94530003c684E7756Dd072,2020000,5,1,4,1010000,1010000,1010000.0,252500.0,0.0,133050.90373236855,1010000,0
0x568d5Ca644Eb1Ce6FbE2e89ad71C8Ac72494e0B5,344757,1,1,0,344757,0,344757.0,0,0.0,0,344757,344757
0xF13AeE15b8fAD7A87D3a8F65372C53503d004d8f,3302341,7,4,3,1658157,1644184,414539.25,548061.3333333334,19643.832713793407,384579.3505336563,820000,13973
0xEe281Db10050Af205E23010bf7101b592Ff20df5,198112,2,1,1,99056,99056,99056.0,99056.0,0.0,0.0,99056,0
0xe7391fB6CEf688f83edd6EeF428297773d45D465,33487,1,1,0,33487,0,33487.0,0,0.0,0,33487,33487
0xEaa4BF4Be7d952BdCc1338C7130f4Da0971e9de8,4670,1,1,0,4670,0,4670.0,0,0.0,0,4670,4670
0x74429847AcDBc81B65cEE95c66Da68da46Fef4b7,20388,1,1,0,20388,0,20388.0,0,0.0,0,20388,20388
0x443111F898ee253C1106fD0Caa34C95F5a872005,6772206,7,3,4,3386103,3386103,1128701.0,846525.75,474427.0085910652,288024.95964618673,1798882,0
0xf95055e467Dd8094D78B9492Ce9924236A0FF395,6772206,7,4,3,3386103,3386103,846525.75,1128701.0,288024.95964618673,474425.63483507786,1798880,0
0x83D3b5B931504C673E7012A87fdafc619b3b23c8,3386103,2,2,0,3386103,0,1693051.5,0,105828.5,0,1798880,3386103
0x97b3584e495FCa3FB5c7B644428097e8b6D68206,2310750,2,1,1,1155375,1155375,1155375.0,1155375.0,0.0,0.0,1155375,0
0x00D84074ee215245b8fA6D11ab03Da6020A9A3Ef,153904,2,1,1,76952,76952,76952.0,76952.0,0.0,0.0,76952,0
0x9c47cDa7079530c51C861578Dd913361B11D0E6F,71518,1,1,0,71518,0,71518.0,0,0.0,0,71518,71518
0x1302490DD94862817dEb3607da489CB39d4DcE9e,13200,1,1,0,13200,0,13200.0,0,0.0,0,13200,13200
0xb781363117b90E2521AfCcE8020bD7cE8c3d797e,6027200,3,2,1,3013600,3013600,1506800.0,3013600.0,1472700.0,0.0,3013600,0
0x30bdEe27d6d5BD7033466249BCb9eC0ee5A66433,4453952,2,2,0,4453952,0,2226976.0,0,2121631.0,0,4348607,4453952
0x73Ded269773E543d8dcD73B32ABAD6026b1964D5,398136,2,1,1,199068,199068,199068.0,199068.0,0.0,0.0,199068,0
0xFCe1Ab301Af520d82aa9AA0067D4f31b51f295af,2501738,2,1,1,1250869,1250869,1250869.0,1250869.0,0.0,0.0,1250869,0
0x806C3CA02800E9aB8D3875C21A8232E68c0140b1,3187296,8,3,5,1593648,1593648,531216.0,318729.6,33728.99329459251,135073.22334437718,578778,0
0x84fB7BeF723b1777bCdaf94237579CE1015DC229,10886372,2,2,0,10886372,0,5443186.0,0,505300.0,0,5948486,10886372
0x039Ac6fBCEbF02B54259bC690e13540693D9eb8D,29046862,16,9,7,14523431,14523431,1613714.5555555555,2074775.857142857,1300321.3418017623,1226064.5643665204,4500290,0
0xC59EB33cB795E0e2497F5615aC1b48491a509CeD,219824,1,1,0,219824,0,219824.0,0,0.0,0,219824,219824
0x7766c509f6c26e4D6609722AD5472D7285e41b2D,28994,2,1,1,14497,14497,14497.0,14497.0,0.0,0.0,14497,0
0x2c0018D70eaf131823f7a9D7e91438D811e0f5C8,5000,1,1,0,5000,0,5000.0,0,0.0,0,5000,5000
0x382fFCe2287252F930E1C8DC9328dac5BF282bA1,156315,32,32,0,156315,0,4884.84375,0,10599.022296034476,0,56630,407775
0xb430A863D52019E2CC5e2c22AeC87b349c384c56,64693,1,1,0,64693,0,64693.0,0,0.0,0,64693,64693
0x93DbeCEf339115fD7663Ae300f39c060353075F5,14073116,2,1,1,7036558,7036558,7036558.0,7036558.0,0.0,0.0,7036558,0
0xdF11b0DdcEE81E106127710d3E43Fc55d6f089cA,21963730,3,2,1,10981865,10981865,5490932.5,10981865.0,1545625.5,0.0,10981865,0
0x5ceF527BDdE0825659bE6ffA23c63603203038B2,5000,1,1,0,5000,0,5000.0,0,0.0,0,5000,5000
0xb27e5bd5d08f8322480637a8115d4Cc9eC468CB5,461000,9,8,1,242000,219000,30250.0,219000.0,16099.301227071937,0.0,219000,23000
0x37dE54be9Ad28C8354012877Ec853f8eD64EEEbB,1266664,2,1,1,633332,633332,633332.0,633332.0,0.0,0.0,633332,0
0xa178Dc86333F80a6c47082c24C744b9C6d522787,7995281,19,19,0,7995281,0,420804.2631578947,0,43919.297964193254,0,452823,9995993
0x7AfA9D836d2fCCf172b66622625e56404E465dBD,11992,5,5,0,11992,0,2398.4,0,3575.696888719736,0,9426,11992
0x7a556F672A2ba0a609504fD0f4b504159E6AE146,2205800,2,1,1,1102900,1102900,1102900.0,1102900.0,0.0,0.0,1102900,0
0xa76Cfe701BEb6Cd5502083E8118F0623043BF792,533890,2,2,0,533890,0,266945.0,0,166637.0,0,433582,533890
0x067306591DCDc297Fd757596C408F17188E2dDE0,2577555,2,2,0,2577555,0,1288777.5,0,855836.5,0,2144614,2577555
0xea19c9d913a9876E0eE12CA613162D8709cfD9A7,22796,2,1,1,11398,11398,11398.0,11398.0,0.0,0.0,11398,0
0xB3e084D2de3Ff9bE4a352e164A722d19d64179c3,32698409,1,1,0,32698409,0,32698409.0,0,0.0,0,32698409,32698409
0x93FFb15d1fA91E0c320d058F00EE97F9E3C50096,7667696,8,4,4,3833852,3833844,958463.0,958461.0,560265.0372645075,560264.8443905793,1607280,8
0xbB13418C2548A435899E59445a78957219DC7E89,40017030,20,8,12,20008515,20008515,2501064.375,1667376.25,1321801.3184658217,470405.8351090976,4272529,0
0x9d5D1a6511aAC74144DF8A274F1BA13751bC28c6,42336,1,1,0,42336,0,42336.0,0,0.0,0,42336,42336
0x045a023f1eF77f9Ef88e77578b9Dd2BF413D50E6,63880,2,2,0,63880,0,31940.0,0,9990.0,0,41930,63880
0x02243480998247cc77fFDa795eb5E64302321655,6060,2,0,2,0,6060,0,3030.0,0,2154.0,5184,2648
0xdDf33359CE09dDD500AC3Bea33B156597887aDc0,876,1,1,0,876,0,876.0,0,0.0,0,876,876
0x024f8484FBb2959204bcc9DD048a4864ED5eec3d,33122,3,3,0,33122,0,11040.666666666666,0,7397.527710135477,0,21099,33122
0xb255f3AFb67352B52b50dF4e586513F45413188d,4543130,5,3,2,3420130,1123000,1140043.3333333333,561500.0,817617.0275103673,138500.0,2296328,2297130
0x48BBDE42C1C13496669928Fb9611487F0Ce5d820,205940,3,2,1,205840,100,102920.0,100.0,102820.0,0.0,205740,205740
0xA998fB34CFA79D5897F5d794e32A7270141aE473,19422228,5,3,2,9711114,9711114,3237038.0,4855557.0,1903241.397986253,0.0,4855557,0
0xd80a39AcFdbE67C094e700f5d5e682E192E07b42,29024,1,1,0,29024,0,29024.0,0,0.0,0,29024,29024
0xe100Fc87a3301bcF56F7a96FDC982597d477E47a,9711114,2,1,1,4855557,4855557,4855557.0,4855557.0,0.0,0.0,4855557,0
0x6235A794E4C3B2c809c3473f118090d90f464579,544842,2,1,1,272421,272421,272421.0,272421.0,0.0,0.0,272421,0
0x79F1491FFCF323d4A0F3Ba3371C1A1Ccf65Ffb38,12438092,5,5,0,12438092,0,2487618.4,0,1274836.986333798,0,3946229,12438092
0x1d74365a071C030D64D560a9867Bea3aEE61509C,110000,2,2,0,110000,0,55000.0,0,38600.0,0,93600,110000
0xF4e7Dfc006e4CD891a89D263cDD5e8ed66965214,4553,1,1,0,4553,0,4553.0,0,0.0,0,4553,4553
0x8C0b7B5c232471f3714272569D476b2545017B16,5338,1,1,0,5338,0,5338.0,0,0.0,0,5338,5338
0x35046785d0E9d91c66eb3c5e58FE7947FEB026cB,3174446,3,2,1,1587223,1587223,793611.5,1587223.0,27651.5,0.0,1587223,0
0xa8376f53391a041C8236A232f7f019EA76eEd86d,14597720,6,2,4,7298860,7298860,3649430.0,1824715.0,843870.0,975660.5973941451,4493300,0
0x76E8946007a1FfB5d1F7D5f89C235fBEDa10c28e,3686222,2,1,1,1843111,1843111,1843111.0,1843111.0,0.0,0.0,1843111,0
0xa865132cd85Df9f2060Db03D857944bE4DaF021E,647530,1,1,0,647530,0,647530.0,0,0.0,0,647530,647530
0x2Cb58822339F8E9af3Fe60eAa60A51C3aD8e46A6,3371923,2,2,0,3371923,0,1685961.5,0,250779.5,0,1936741,3371923
0x1D55C93B1EEa2950A62de16754BbF2d2d2E16520,844,2,1,1,422,422,422.0,422.0,0.0,0.0,422,0
0x3e4fFF186Bd9518d8753bcfb964Fa76e2ab6150F,422,1,1,0,422,0,422.0,0,0.0,0,422,422
0x3B82fF2eA45595c8D0C79a2E5749b7347dd4970a,18299064,25,13,12,9149532,9149532,703810.1538461539,762461.0,337985.5400525172,284132.1334232837,1260364,0
0x52E2714bD2c0120D25b8A017c452c1fb9b266469,10632,1,1,0,10632,0,10632.0,0,0.0,0,10632,10632
0xb41Da434E2A7997f5c97Ae3333963F04C492c40a,1433556,2,2,0,1433556,0,716778.0,0,689890.0,0,1406668,1433556
0xDB32935253d1cf017C0068e0903A99526575DBAd,55780,2,2,0,55780,0,27890.0,0,8241.0,0,36131,55780
0x5AaabCbF33D2820B57E9BE51A365E81568734E46,32843938,5,4,1,25843938,7000000,6460984.5,7000000.0,3209806.5437017772,0.0,10236590,18843938
0xdbCac67084fc86C550740FD6dc55261f964B2146,123760476,4,3,1,61880238,61880238,20626746.0,61880238.0,23203632.778419677,0.0,61880238,0
0x26c7D766449FA8Cabb3281721Ec40dC37BEcE94E,686462,2,1,1,343231,343231,343231.0,343231.0,0.0,0.0,343231,0
0xd158637f7a7bAC0E16e83e532b8d01edc77c4797,14000000,2,1,1,7000000,7000000,7000000.0,7000000.0,0.0,0.0,7000000,0
0xaD210F9aA379384294364C1C2D2757e67f418cf6,14000000,2,1,1,7000000,7000000,7000000.0,7000000.0,0.0,0.0,7000000,0
0xA947B9F0B727255Be2ce520F2490A71A061cc981,381877,1,1,0,381877,0,381877.0,0,0.0,0,381877,381877
0x892aCF5E248463676479d3C26b735F43b8Aa8864,2782828,3,2,1,1391414,1391414,695707.0,1391414.0,235310.0,0.0,1391414,0
0x47585f55a7DAE800B5f396564704abFE6AcDCC70,1949056,2,2,0,1949056,0,974528.0,0,392179.0,0,1366707,1949056
0x6062fea79B667EcEeD7E4A04cB7b64EeF41e4E3a,658470,1,1,0,658470,0,658470.0,0,0.0,0,658470,658470
0x74E2e70bE76092E7f913043abbB906dcFAe3673d,1030242,1,1,0,1030242,0,1030242.0,0,0.0,0,1030242,1030242
0xC451b0191351ce308FdFd779D73814c910FC5eCB,43079056,2,1,1,21539528,21539528,21539528.0,21539528.0,0.0,0.0,21539528,0
0xef9415B9420FE3f698A3Ba54Af95b098f4C22CF2,1164766,2,1,1,582383,582383,582383.0,582383.0,0.0,0.0,582383,0
0x037F01af83bf8c9e1C7Bbb513a0a2a6969c49E34,1967970,3,2,1,983985,983985,491992.5,983985.0,25099.5,0.0,983985,0
0xe1689e35222e7b45e4Abdd6359F734e1aB21b512,7654,1,0,1,0,7654,0,7654.0,0,0.0,7654,0
0x43686Cb7d88cd9AB18Eb351Bf8E15f51A7bCa473,2069063,1,1,0,2069063,0,2069063.0,0,0.0,0,2069063,2069063
0x429C45F1C9BD3Ec0363eAE7F0849856fD3825Ff6,3720534,2,1,1,2360534,1360000,2360534.0,1360000.0,0.0,0.0,2360534,1000534
0x32336195759243455e4A056bf694368c251c137C,2834651,3,3,0,2834651,0,944883.6666666666,0,636278.7471710456,0,1844699,2834651
0xB17f1d6d9202537C8778f2D3B2Ee0226884851fc,19608272,2,1,1,9804136,9804136,9804136.0,9804136.0,0.0,0.0,9804136,0
0x4Cc7D36976fE0b3745aE2F42E5cE6668c4f7FBa9,25434,2,2,0,25434,0,12717.0,0,8424.0,0,21141,25434
0xEB663358fc5dc3fa402D72134bA00fa1948c6fbc,117,1,1,0,117,0,117.0,0,0.0,0,117,117
0x75537bcA6f05950f8aD13eFc4Ed52ccC9472614E,477557869,6,3,3,277557869,200000000,92519289.66666667,66666666.666666664,66500621.40126008,23570226.039551582,153803252,77557869
0x15313dA33C41550303358E81929Cb0670Db9caf3,3351780,4,3,1,1675890,1675890,558630.0,1675890.0,122819.80312908284,0.0,1675890,0
0x52d77cdaECA5236e4A7d10C5De712D01883b5cB5,72543,1,1,0,72543,0,72543.0,0,0.0,0,72543,72543
0x9B02e5442972676812aacC0b373174FfCDf35a03,11739513,3,3,0,11739513,0,3913171.0,0,509122.2548982382,0,4273978,11739513
0x8a005455c11E61606d3b717d1f15915Af082Db67,3000,1,1,0,3000,0,3000.0,0,0.0,0,3000,3000
0x2C317942EA356a3e2CD637A5C272BED662d67DBf,79386920,2,1,1,39693460,39693460,39693460.0,39693460.0,0.0,0.0,39693460,0
0xeD2Fbe806a6A47168B8A752FC06dF933A96b051F,62699190,2,1,1,31349595,31349595,31349595.0,31349595.0,0.0,0.0,31349595,0
0x93EfFde8a804DeA67D2F6849E9f979547394e704,7116038,1,1,0,7116038,0,7116038.0,0,0.0,0,7116038,7116038
0xd70A5e62c8BB0De15C385D935B41B44d0fF8DD3d,25152,2,1,1,25076,76,25076.0,76.0,0.0,0.0,25076,25000
0x409E730f8fBD3AD0E72A1c20bC9eA41BFa8a9e08,76,1,1,0,76,0,76.0,0,0.0,0,76,76
0xA6Fb19258AD7acF0DfBd2F65785A53AE05894229,10407,1,0,1,0,10407,0,10407.0,0,0.0,10407,8880
0x9e4b116c8B01FBD05a9A1299D5CE90360ccF6165,20814,2,1,1,10407,10407,10407.0,10407.0,0.0,0.0,10407,0
0x5d74DB9B238F3C56B89F310EeB6D73E0BE51516A,36845,1,1,0,36845,0,36845.0,0,0.0,0,36845,36845
0xbE6E7aebA8b87BF456Dfd780FBF038A85dde8F69,14003,4,3,1,11723,2280,3907.6666666666665,2280.0,4023.2272562652433,0.0,9443,9443
0xca7DA24Daf98B22450dd72Bd6458407e1DDA3490,4560,2,1,1,2280,2280,2280.0,2280.0,0.0,0.0,2280,0
0xfd7Ec7f08548e14B7cFA75D70d624af33b5305C2,9003000,2,2,0,9003000,0,4501500.0,0,4498500.0,0,9000000,9003000
0x111111125421cA6dc452d289314280a0f8842A65,7027020,10,5,5,3513510,3513510,702702.0,702702.0,1181072.234307284,1181072.234307284,3044950,0
0x8729725859A9de5418b0448552C85759b7E42425,53176,1,1,0,53176,0,53176.0,0,0.0,0,53176,53176
0xC56055a779B9523fb75eE85e29475ce20Eefc454,227868,2,1,1,113934,113934,113934.0,113934.0,0.0,0.0,113934,0
0x356ca8051dD211cB36FB823bE6E91Fbf2942f128,103438,2,1,1,51719,51719,51719.0,51719.0,0.0,0.0,51719,0
0x48e007325e6F077FA0f7eF53b94DB6DD6885d153,148044,4,2,2,74022,74022,37011.0,37011.0,352.0,352.0,37363,0
0x37a8f295612602f2774d331e562be9e61B83a327,169096,61,60,1,115476,53620,1924.6,53620.0,2605.137361701554,0.0,53620,61856
0x93C12D105731dcB8eb2D479cB1a1C645AB0624eD,35000,1,0,1,0,35000,0,35000.0,0,0.0,35000,0
0x5aeBDa2e74219a0Ff0D29Cf2c473F83Ef89B46E8,210000,4,3,1,105000,105000,35000.0,105000.0,0.0,0.0,105000,0
0xE9bbd955A2cDeF725E5eB7EB15548076F1BD4253,35000,1,0,1,0,35000,0,35000.0,0,0.0,35000,0
0xD925531A2Ef2a0aB0D601e6cdAa3eDedAE3dB8C0,35000,1,0,1,0,35000,0,35000.0,0,0.0,35000,0
0xc4167875cdd87602b4031E70F744C303Ca5892b7,280098,3,2,1,140049,140049,70024.5,140049.0,10972.5,0.0,140049,0
0x5F935F5e8f2F642C44f10BDc50A63823aD8EB39b,18886,3,1,2,9443,9443,9443.0,4721.5,0.0,4721.5,9443,0
0xD3DcdC9BA2aD5fE88f6Bf47F0fE6b28d401e433F,46955,1,1,0,46955,0,46955.0,0,0.0,0,46955,46955
0x86cb19527733ccD8fC2D7439C4D52Fc3B8edFd69,47220,2,1,1,23610,23610,23610.0,23610.0,0.0,0.0,23610,0
0x79d094b6989DF247e6aFE38C3079de2cb996F2E8,83039,1,1,0,83039,0,83039.0,0,0.0,0,83039,83039
0x37CFc46CAb8cD5fe63b147a12FabEfA6BFbd52A3,544354,3,3,0,544354,0,181451.33333333334,0,83968.76347917851,0,273755,544354
0x9158811AC02E07FA6731a3e27C6981eaA5601E7d,62699190,2,1,1,31349595,31349595,31349595.0,31349595.0,0.0,0.0,31349595,0
0x8782157055670B1Ae2Fb4C26252DC7dADe249B33,1490000,1,1,0,1490000,0,1490000.0,0,0.0,0,1490000,1490000
0x28D20A1EB8Bf597c815935BAAEe62Db7EDCf7B9B,64075014,4,2,2,32037507,32037507,16018753.5,16018753.5,9974926.5,9974926.5,25993680,0
0x3d80c1c9bC6580c36c4ea1Cf4b0DFea253593c1C,2720035,1,1,0,2720035,0,2720035.0,0,0.0,0,2720035,2720035
0x1F1509E4B040C6CA9fbaD22682f8e8b0ceb41eBB,18228312,2,1,1,9114156,9114156,9114156.0,9114156.0,0.0,0.0,9114156,0
0x83BF9E63Bae1386AAdfEe8F5F17CD63CD1460781,1043431,1,1,0,1043431,0,1043431.0,0,0.0,0,1043431,1043431
0x6A2878Caa928c8Fd942808B49F7f358D7ac642a2,6280,1,1,0,6280,0,6280.0,0,0.0,0,6280,6280
0x38CA2c9406b4CD29f619cB7651033F4d12Ac9C6a,126583,1,1,0,126583,0,126583.0,0,0.0,0,126583,126583
0xed18ceD1591676dD0Adea3dAFdb8112a5d6424dF,42409,1,1,0,42409,0,42409.0,0,0.0,0,42409,42409
0xc251B2Ffe3674f3A16e842587C9dC27E5098294E,4350,1,0,1,0,4350,0,4350.0,0,0.0,4350,0
0x147C46BB74D0fa2e62Ceac29835a686131940367,4350,1,1,0,4350,0,4350.0,0,0.0,0,4350,4350
0xA8810994379423B7271E6235b1dcAd6ced50f55f,1113668,2,1,1,556834,556834,556834.0,556834.0,0.0,0.0,556834,0
0x29D5B6F6dDA54f3EC58d32A22CbefDC3b8676bD5,1049068,2,1,1,524534,524534,524534.0,524534.0,0.0,0.0,524534,0
0x3CA8F7394433c6356746ec4C905Bf44b729FA29B,840686,2,1,1,420343,420343,420343.0,420343.0,0.0,0.0,420343,0
0x1bD87edF0D90bbC45EE09538907D780e3d6c33c6,19964000,2,1,1,9982000,9982000,9982000.0,9982000.0,0.0,0.0,9982000,0
0xac8B1E6987aCfe6a4711023313F2faF9a3Fc7923,1085560,2,1,1,542780,542780,542780.0,542780.0,0.0,0.0,542780,0
0x2031E8f0DdA645370bBc94eE5CFb052BED2d67F5,20907,1,1,0,20907,0,20907.0,0,0.0,0,20907,20907
0x7ebA339140A12DfbA00Ff4A83040AAdBee9fCa17,1034874,2,1,1,517437,517437,517437.0,517437.0,0.0,0.0,517437,0
0x5B24ef3FE55061E85068f5511BeC5026f2C93C5B,120845,1,1,0,120845,0,120845.0,0,0.0,0,120845,120845
0x46525cAa6B6209b57195a54bF96BC28D69a17115,6636610,1,1,0,6636610,0,6636610.0,0,0.0,0,6636610,6636610
0x96faa833B840C0984bfcE21dc42b4C481b41f79C,149968702,2,2,0,149968702,0,74984351.0,0,24992831.0,0,99977182,149968702
0xA6Fa42D213D3E26376be4246843aFd0fD7895C66,7697,1,1,0,7697,0,7697.0,0,0.0,0,7697,7697
0x81978F6e2dA852E0183713A23290EC120101Dbbc,21963730,2,1,1,10981865,10981865,10981865.0,10981865.0,0.0,0.0,10981865,0
0x9e5017C5bD125984Ac58c6160105741168fAD656,3686222,2,1,1,1843111,1843111,1843111.0,1843111.0,0.0,0.0,1843111,0
0xb3Ccf96383D22F40662691581fA80144152f56B8,57739,1,1,0,57739,0,57739.0,0,0.0,0,57739,57739
0x102A3001A98ffB1008c5B9aCdb3a31933F81fdcE,8542,1,1,0,8542,0,8542.0,0,0.0,0,8542,8542
0x860AC2ca6e5AA4dEf7F844203639fAE58Eccb817,314413,1,1,0,314413,0,314413.0,0,0.0,0,314413,456757
0x99d54E522Cf4E5ac8e49D97775BbD5bc365C0EB0,63706,2,1,1,31853,31853,31853.0,31853.0,0.0,0.0,31853,0
0x8153844afCde7Fc52Dc0214cbE9A792108B815Be,33508,1,1,0,33508,0,33508.0,0,0.0,0,33508,33508
0x594FcF750721300618679303b78AD4Ca8F0bd055,72731939,1,1,0,72731939,0,72731939.0,0,0.0,0,72731939,72731939
0x8A61AD304bD67956681F80570dFAC658E7cc7E68,60,1,1,0,60,0,60.0,0,0.0,0,60,60
0x7699D4f59Ee9f5A7Cafe530A923D77D54578D3da,103438,2,1,1,51719,51719,51719.0,51719.0,0.0,0.0,51719,0
0x3F3695d69D158Bb5C7dAa8b6D57Eb85e5035cc41,500000,1,1,0,500000,0,500000.0,0,0.0,0,500000,500000
0x090112759E4eBD409cf1F7CDf4e5A7137caC59ce,11627140,2,2,0,11627140,0,5813570.0,0,5713570.0,0,11527140,11627140
0x4F9C6b01D3a0576E6Cf2eeE0FC00158836750293,10028800,4,2,2,5014400,5014400,2507200.0,2507200.0,1745800.0,1745800.0,4253000,0
0x28DAa79459a40397F4cc20dFCdf853740ED84955,1790276,4,3,1,895138,895138,298379.3333333333,895138.0,73099.17675019025,0.0,895138,0
0x185b5323a39804a069B8b2D6514dBf2eD96c823c,209826,1,1,0,209826,0,209826.0,0,0.0,0,209826,209826
0x9c3bD567d322841E9d01417E4a78ceb1F485179B,3332260,6,4,2,1666130,1666130,416532.5,833065.0,4593.954587280984,8965.0,842030,0
0xc8C0e780960f954c3426A32b6ab453248D632B59,11410,2,2,0,11410,0,5705.0,0,3619.0,0,9324,11410
0x120BC9ac3Bd4fDFb02BF0Ce8332Ad454D67693F1,4624864,4,2,2,2312432,2312432,1156216.0,1156216.0,0.0,0.0,1156216,0
0x0Ddac2eb8C8DDBF5F5889C3697C8Df1755762915,332000000,5,3,2,166000000,166000000,55333333.333333336,83000000.0,57563491.51637308,52000000.0,135000000,0
0xd3ceE63605Af52498629504e0f24E14AA343a6bd,2312432,2,1,1,1156216,1156216,1156216.0,1156216.0,0.0,0.0,1156216,0
0xb849e2a039Ee4349CFFA141637d1bEFf6ECf58f8,1054,1,1,0,1054,0,1054.0,0,0.0,0,1054,1054
0x8251321719179B7Dc5680c5722741347756753ec,4200000,3,2,1,2100000,2100000,1050000.0,2100000.0,950000.0,0.0,2100000,0
0xbF90dE55dCF5DDa3755F89f59d7199cbF19496dE,27076030,6,4,2,13538015,13538015,3384503.75,6769007.5,1484549.2247282297,1755682.5,8524690,0
0x8b4EB6d9b6Ee486F4799373362c3A7eAF4A50aE6,294423496,8,4,4,147211748,147211748,36802937.0,36802937.0,13748170.927170893,13748170.927170893,57224448,0
0xE0a616C3659bE29567E08819772e6905307AdF21,1502570,3,1,2,993670,508900,993670.0,254450.0,0.0,39950.0,993670,492870
0xD9f71B952EF4D81A083E0D7b13963d241FEB14c3,214500,1,1,0,214500,0,214500.0,0,0.0,0,214500,214500
0x61459D345779B9d8Ceaf2b1472a60805Cb699aaE,1000000,1,0,1,0,1000000,0,1000000.0,0,0.0,1000000,4190000
0x02ea1da49c430f1997795055813e89479Db0a755,2000000,2,1,1,1000000,1000000,1000000.0,1000000.0,0.0,0.0,1000000,0
0x24efb43032ECD8e1CF893e521A655F302407b08c,250492,1,1,0,250492,0,250492.0,0,0.0,0,250492,250492
0x77606F8B8f6aDE4718Dd469315F0CFb828668a55,3225780,2,1,1,1612890,1612890,1612890.0,1612890.0,0.0,0.0,1612890,0
0x01F9126E58F1a61EF6a48adBc2C8D1C562A2C19E,400000000,6,3,3,200000000,200000000,66666666.666666664,66666666.666666664,23570226.039551582,23570226.039551582,100000000,0
0x0fFb68b7D39d5DD66fde64465CDFf757A664760A,1392,1,1,0,1392,0,1392.0,0,0.0,0,1392,1392
0xa88177909bFA4882C55812Fc8360feCEa81CD32e,83844,1,1,0,83844,0,83844.0,0,0.0,0,83844,83844
0x3Ba343423B443a81Fb85a90aECe46C7009C6A64c,418627,1,1,0,418627,0,418627.0,0,0.0,0,418627,418627
0x0D976579AbD2e35D0d2d2a9048cF9194C873dABf,63706,2,1,1,31853,31853,31853.0,31853.0,0.0,0.0,31853,0
0x0059490FcCF760c8575B90F4B17ca49a75260949,1007800,2,1,1,503900,503900,503900.0,503900.0,0.0,0.0,503900,0
0x56b1cA4A3FFaFf32c395c7C3945CfB2CF9f109c5,22234,1,1,0,22234,0,22234.0,0,0.0,0,22234,22234
0xBA312e4f4e265F6bBcF2cfB5c8faF2E516Deb0D1,24020750,2,1,1,12010375,12010375,12010375.0,12010375.0,0.0,0.0,12010375,0
0x1094E767964205c7af03898bBA1341C8e90b5DB1,423809,1,1,0,423809,0,423809.0,0,0.0,0,423809,423809
0x9f0962065Fe2A1B92b58a4fc4318f0509b2C8C2A,3003053,1,1,0,3003053,0,3003053.0,0,0.0,0,3003053,3003053
0x2749a92c2Da1803b81E650374871fCb023B7cd51,196134,1,1,0,196134,0,196134.0,0,0.0,0,196134,196134
0x5210019649929559005a75Fcd962BFe5194A99D8,1881088,3,1,2,940544,940544,940544.0,470272.0,0.0,469854.0,940544,0
0xeBb469200ef0902478BaFA1Fa77926d21CdeD338,12804,1,1,0,12804,0,12804.0,0,0.0,0,12804,12804
0xa47B1FC5ed4b296Dea37806120D9BceFccD80ba6,6089900,2,1,1,3044950,3044950,3044950.0,3044950.0,0.0,0.0,3044950,0
0x6eB50973F9f1c54B262D2b8394b0fD00BF2F66D0,3044950,1,1,0,3044950,0,3044950.0,0,0.0,0,3044950,3044950
0xdF6F78Bc5fBeb5FB218FFa71B7e1C2eEFb417161,15483,1,1,0,15483,0,15483.0,0,0.0,0,15483,15483
0x02a7299fa1047d5C6c40C7aC7cc85882852433c7,896972,4,3,1,448486,448486,149495.33333333334,448486.0,69980.96057897144,0.0,448486,0
0xfd111e34b31365f800a0Eb1A85E39aD2ED1920Ef,3563889,1,1,0,3563889,0,3563889.0,0,0.0,0,3563889,3563889
0xcbeC39236c17B776ee49348772Ce1C5d108b0A37,160986386,3,1,2,80493193,80493193,80493193.0,40246596.5,0.0,40146596.5,80493193,0
0x21000D76104eAC76629Eff711184BDC1C27d157c,92870,1,1,0,92870,0,92870.0,0,0.0,0,92870,92870
0xC48485c211842437dB9D4F0092024b7411CC1ec0,2105533,1,1,0,2105533,0,2105533.0,0,0.0,0,2105533,2105533
0x83C8079aa7061EC5449BbBe1f07Bb0451B83804E,16792,1,1,0,16792,0,16792.0,0,0.0,0,16792,16792
0x1f0be889b0c0671fBc79F3835F701f9cde02E0a9,129638,3,2,1,64819,64819,32409.5,64819.0,4929.5,0.0,64819,0
0x4463FE6E28BdD5e2F64F67Bb45E6Cac8f5245dbD,84958,2,2,0,84958,0,42479.0,0,6282.0,0,48761,84958
0xe9f9B38B14f87099eAb04f7A17cfbc4Ca68f93C2,3067,1,1,0,3067,0,3067.0,0,0.0,0,3067,3067
0xa014eD33D8395370735058314F5e40A55F8bb900,202586386,14,7,7,101293193,101293193,14470456.142857144,14470456.142857144,27022151.69041552,27022151.69041552,80393193,0
0xae7216B155F8001272b64D739Fd4c86ed43cFF9F,2212556,2,1,1,1106278,1106278,1106278.0,1106278.0,0.0,0.0,1106278,0
0xC7EbdB6972bF040cA4b36C4Ec784226698F337F5,1106278,1,1,0,1106278,0,1106278.0,0,0.0,0,1106278,1106278
0x4F7A87EBe2C211b54d893CfB47953EA58FB43b5a,10504,2,1,1,5252,5252,5252.0,5252.0,0.0,0.0,5252,0
0xAdCFcf9894335dC340f6Cd182aFA45999F45Fc44,19505,2,0,2,0,19505,0,9752.5,0,3920.5,13673,130482
0xc5FA220347375ac4f91f9E4A4AAb362F22801504,39010,4,2,2,19505,19505,9752.5,9752.5,3920.5,3920.5,13673,0
0xB9Ae2236004C0C787041A977E03C268902Fccc2d,13673,1,1,0,13673,0,13673.0,0,0.0,0,13673,13673
0x9B7031923fEdaFc57CEe143f27e8b08A14CA6299,5832,1,1,0,5832,0,5832.0,0,0.0,0,5832,5832
0x25EEAC5fF395b6392DC54a38E29C25859bA88fcA,70744148,63,56,7,35372074,35372074,631644.1785714285,5053153.428571428,839447.7475555008,4100616.27695611,13010588,0
0xb537751548151186374309f01c9776Bb3f5f7B36,2720000,2,1,1,1360000,1360000,1360000.0,1360000.0,0.0,0.0,1360000,0
0xA515371811B0845AD89Ed81910a4558544079E32,1030668,2,1,1,515334,515334,515334.0,515334.0,0.0,0.0,515334,0
0xa85cF24CAc34423616564b0949CbE0E1dd8Cf8E9,8362,1,1,0,8362,0,8362.0,0,0.0,0,8362,8362
0x2fbB730BA60391B8a3b78F68a8714AC1577a34b8,1000000,3,2,1,500000,500000,250000.0,500000.0,0.0,0.0,500000,0
0x83cE3782554b3d851AcE800F479986fEdf6279a6,623474,1,1,0,623474,0,623474.0,0,0.0,0,623474,623474
0xC3e4C2139cc65669F0cD4B52B59cB5BF8Aab4441,674448,2,2,0,674448,0,337224.0,0,111262.0,0,448486,674448
0x453FaA95711a2a2936647F316F777F07613e2A9e,10452,1,1,0,10452,0,10452.0,0,0.0,0,10452,10452
0x5831e8b268B0615e248CC6a7857863BE6f887934,634072,4,2,2,317036,317036,158518.0,158518.0,34251.0,34251.0,192769,0
0xC4dfaFAd78fDbd16612aA02f060feA79CD54cB8a,5184,1,1,0,5184,0,5184.0,0,0.0,0,5184,5184
0x6B3B9c7B899f5aAc45c66F0350D9f053D1de7C1f,2005890,1,0,1,0,2005890,0,2005890.0,0,0.0,2005890,0
0xE569d513307E2cbCd6ACa84175A6b2eDd5e314E3,2560000,2,1,1,1280000,1280000,1280000.0,1280000.0,0.0,0.0,1280000,0
0x3F9FBa09BC22FfE4140D2DB9dd7830FbA1393bB0,4955272,6,3,3,2477636,2477636,825878.6666666666,825878.6666666666,237414.8825387509,237414.8825387509,1035701,0
0x533b08B2f1C84eADf64Ee2CD448aBe488452eac3,994000,1,1,0,994000,0,994000.0,0,0.0,0,994000,994000
0x397699Bf1D1923C5FAC9FD73C642f88C83c493a5,2000000,2,1,1,1000000,1000000,1000000.0,1000000.0,0.0,0.0,1000000,0
0x649cC3693935073fC910B98F1156E309441828D9,1000000,1,1,0,1000000,0,1000000.0,0,0.0,0,1000000,1000000
0x2e1E1D7ee83FC218A1e39297f40DFBA7F03772B1,2000000,2,1,1,1000000,1000000,1000000.0,1000000.0,0.0,0.0,1000000,0
0xaB9f0e58CaD6cAb51bBFc4cC451bCceD0a88E4CE,66000,2,0,2,0,66000,0,33000.0,0,12000.0,45000,2896
0x4E1e2ad76CFE15e775d6DB7E816543e35de2E1b2,388820,2,1,1,194410,194410,194410.0,194410.0,0.0,0.0,194410,0
0x8FEa0700FE1fFA3922a0837BC9770D50eD353435,250920,1,1,0,250920,0,250920.0,0,0.0,0,250920,250920
0xA863135e25E1bB926c0e6De7582553D32A19dFa3,23,1,1,0,23,0,23.0,0,0.0,0,23,23
0xC23cc070123594619876A76e2E7709FEF4a697Ab,146901,2,2,0,146901,0,73450.5,0,27028.5,0,100479,146901
0x80C1969588bD9a017190ff4ed669e4e4b70e7768,5025074,4,2,2,2512954,2512120,1256477.0,1256060.0,9357.0,8940.0,1265834,834
0x86F236e868A367E38AB74Def11480bEA14B7D172,32739,1,1,0,32739,0,32739.0,0,0.0,0,32739,32739
0x37426d73Fc6F9195188290188C09fadCB5924a93,149868,1,1,0,149868,0,149868.0,0,0.0,0,149868,149868
0x37c6fCeC5575c4fbb148eC296D4166B182679e07,110006730,3,2,1,90003730,20003000,45001865.0,20003000.0,4998135.0,0.0,50000000,70000730
0xaF670FeB033280FcA72c8F11d6cFb0c598f3C9E1,123760476,2,1,1,61880238,61880238,61880238.0,61880238.0,0.0,0.0,61880238,0
0x80BfC4442E7403401721C39df59Cd2eE7724FA6b,3981608,2,1,1,1990804,1990804,1990804.0,1990804.0,0.0,0.0,1990804,0
0x536aC56322A9914042721a6Ea45361B9aFE054A9,114952,1,1,0,114952,0,114952.0,0,0.0,0,114952,114952
0xeC636E2b6Bc7BF3b0b98bA530F7f5A5081F2FfA3,940544,2,2,0,940544,0,470272.0,0,469854.0,0,940126,940544
0x6b497DeeAbe69b0fc25A80E8Ab94A4c1F6ad2f96,91624,1,1,0,91624,0,91624.0,0,0.0,0,91624,91624
0x69460570c93f9DE5E2edbC3052bf10125f0Ca22d,154414,2,1,1,77207,77207,77207.0,77207.0,0.0,0.0,77207,0
0x0178354373b69AbCd6476D00fe5D0b9b20405cd6,154414,2,1,1,77207,77207,77207.0,77207.0,0.0,0.0,77207,0
0x0caD9C1945b199E2c2E8059c8e98dAefd171B397,19762,1,1,0,19762,0,19762.0,0,0.0,0,19762,19762
0xe634f7E746bE6eF66dB5cEF785299aB13C0dbF93,1996782,1,1,0,1996782,0,1996782.0,0,0.0,0,1996782,1996782
0x4171919C21558bBba02A6bD3EA1a4fAE814AA755,4127,1,1,0,4127,0,4127.0,0,0.0,0,4127,4127
0x3dC721aFD9F6f8BcA9Ee4Eabb103cDfBdf0AD77a,11213,1,1,0,11213,0,11213.0,0,0.0,0,11213,11213
0x363DAC949941864176Fd5138e23777922b48Cc92,2363340,3,1,2,1181670,1181670,1181670.0,590835.0,0.0,500835.0,1181670,0
0xA7e79D95766407fbc135e1C51410ca3966667ADD,5004038,4,2,2,2502019,2502019,1251009.5,1251009.5,812048.5,812048.5,2063058,0
0xd034541BCa36dDb96320F4F40D0b5262b00F7Ac5,119820,1,1,0,119820,0,119820.0,0,0.0,0,119820,119820
0xf9b205640ab5a45762b3E3a2A29cE0B56d941533,25000,1,1,0,25000,0,25000.0,0,0.0,0,25000,25000
0x8EaD7361cF10DE6fA007eC0594d078B5b1014149,52514,1,1,0,52514,0,52514.0,0,0.0,0,52514,52514
0xDB61979bbb9AA913E139365258a6c340981EBEC7,35172074,6,6,0,35172074,0,5862012.333333333,0,3877859.4264476057,0,13010588,35172074
0xc6486aaeF4B53Dfeb6867764Cc20132518F9F058,10000,1,1,0,10000,0,10000.0,0,0.0,0,10000,10000
0x8A000092547C00169c00b3dd0E76DE0000Fd6E00,6068040,8,4,4,3034022,3034018,758505.5,758504.5,117182.43362701595,117182.43362701595,961471,4
0x4C51828DA32b0d7410084DAf88245D7f0213446c,17212,2,2,0,17212,0,8606.0,0,92.0,0,8698,17212
0xCf5540fFFCdC3d510B18bFcA6d2b9987b0772559,4493252,3,2,1,2246626,2246626,1123313.0,2246626.0,260660.0,0.0,2246626,0
0x3F47A66aDA01491c3d364599e5bcBf80A1a67092,10104372,4,2,2,5052186,5052186,2526093.0,2526093.0,279467.0,279467.0,2805560,0
0x46CeeEE162E9c899F541ee9c08028496aa6F7488,358025,2,2,0,358025,0,179012.5,0,26526.5,0,205539,358025
0x5b8425404c1F44B3Bb638028f9c82576054B4505,4740000,2,1,1,2370000,2370000,2370000.0,2370000.0,0.0,0.0,2370000,0
0x70c9074EA2D75e7B5f9d6B63ef9B2578Eb8674B8,5332021,4,2,2,2666021,2666000,1333010.5,1333000.0,690063.5,774000.0,2107000,21
0x0b1FF76094B2155D179c8738de1F3108E1026015,34600,1,1,0,34600,0,34600.0,0,0.0,0,34600,34600
0x6c30E15499164c62475fe256b2EB1e8FA49c167D,40006000,2,1,1,20003000,20003000,20003000.0,20003000.0,0.0,0.0,20003000,0
0x5619EDFE7579Ce3582e440BC8D2446BF3EAF3Daf,182461,1,1,0,182461,0,182461.0,0,0.0,0,182461,182461
0xd93533b014839B9018C702391681EFd5A11004C8,398510,1,1,0,398510,0,398510.0,0,0.0,0,398510,398510
0x7409E8d7F785922E2f8FfdF425a09f3c550f5039,7066,1,1,0,7066,0,7066.0,0,0.0,0,7066,7066
0x39D4f2E0C2188cBdE030eE8De1a85eEb23a2Be41,249121,3,3,0,249121,0,83040.33333333333,0,34128.7890432045,0,128130,249121
0xa1CA525804C8bc4df7088B3809FFaB1ebAC02022,3441610,1,1,0,3441610,0,3441610.0,0,0.0,0,3441610,3441610
0x69d036974cedBe7b4F73fB78d0C419495f3AF8f8,714648,4,1,3,411148,303500,411148.0,101166.66666666667,0.0,29934.18707023051,411148,107648
0xAB155c3B85141118a3a74A84560EFf78dd9Df7Bc,148044,4,2,2,74022,74022,37011.0,37011.0,352.0,352.0,37363,0
0x78d3ddc334caF78daF0aBc2d2bA3927D281aFb02,456632,4,2,2,228316,228316,114158.0,114158.0,0.0,0.0,114158,0
0x9E64dE9eA523a21c21888E39A19518C065A82Fe6,228316,2,1,1,114158,114158,114158.0,114158.0,0.0,0.0,114158,0
0x181e220f33F8A5c1093B9857858240F664157Ae3,14000,1,1,0,14000,0,14000.0,0,0.0,0,14000,14000
0xc4250d9ED8599388f099dE246908215e9CB228c5,127117,3,3,0,127117,0,42372.333333333336,0,100.18094740130093,0,42514,127117
0xFD1084DE2cceDf5158F40835F0357Aa647235595,1415696,2,1,1,707896,707800,707896.0,707800.0,0.0,0.0,707896,96
0x7CAff22E4a7350712365c756D59d48ABa4Ee5C42,2498270,2,1,1,1249140,1249130,1249140.0,1249130.0,0.0,0.0,1249140,10
0xfC53c771017aE987e95B7a64a42a86df39E34C51,14215686,2,1,1,7107846,7107840,7107846.0,7107840.0,0.0,0.0,7107846,6
0x0351af255Aa1210AE37DC7881b3c128d59817796,37689,1,1,0,37689,0,37689.0,0,0.0,0,37689,37689
0xf072bBF692c9BCe64745D8c282d6B107054dA3Ba,5094508,2,1,1,2547254,2547254,2547254.0,2547254.0,0.0,0.0,2547254,0
0x97B2135781383fb62A8BEfD6cc48D11585D73c9A,22747688,2,1,1,11373848,11373840,11373848.0,11373840.0,0.0,0.0,11373848,8
0x4Edf1aC063398378659047714d02555217615818,250000,1,0,1,0,250000,0,250000.0,0,0.0,250000,3944363
0x13257Bae981529a6bd47BB38fc3c7C18355Bf2D4,250000,1,1,0,250000,0,250000.0,0,0.0,0,250000,250000
0x5135F4528a0e2E94E6Fd7943D1f114d7C1A8A6c9,6774,1,1,0,6774,0,6774.0,0,0.0,0,6774,6774
0x841Cf61d109c87c5996cF0131e86Dd295bFe66a4,101333,4,4,0,101333,0,25333.25,0,7973.455348059585,0,33917,101333
0xF5aAE5276b1ED63544edB779Dcd7e449a7d8017B,9283502,4,2,2,4641751,4641751,2320875.5,2320875.5,1086134.5,1086134.5,3407010,0
0xba577B7fF962B49A8E9BbD9b0fdB2D6E19A9D267,45330,1,1,0,45330,0,45330.0,0,0.0,0,45330,45330
0x4839511fb4a48c1cF7E6aCFbE38c0D403A9720c4,1623099,1,1,0,1623099,0,1623099.0,0,0.0,0,1623099,1623099
0x11b5e56931076571653C68483056b3006d1Aac49,1010946,1,1,0,1010946,0,1010946.0,0,0.0,0,1010946,1010946
0x52115E530ae77Dde84bBD2b6ff59Bd83c9fcC4e3,2137280,1,1,0,2137280,0,2137280.0,0,0.0,0,2137280,2137280
0xD8AF6fec80e844632Ac4A9880271CE233EfB9633,5795,1,1,0,5795,0,5795.0,0,0.0,0,5795,5795
0xf74f918073ebc616B3d5fd7bee05c3CD8536bB77,147629,1,1,0,147629,0,147629.0,0,0.0,0,147629,147629
0xa0DcA19163E837F14dCD216E98f0c4A0eA28E19a,13919074,4,2,2,6959544,6959530,3479772.0,3479765.0,1155469.0,1420235.0,4900000,14
0x509Bff5B7Ab8767C78c8229005627Ef19a2b53C8,9475,1,1,0,9475,0,9475.0,0,0.0,0,9475,9475
0x40CFDd3DA439a1C81cd671F577D062c3cE8b9516,589520,2,1,1,294760,294760,294760.0,294760.0,0.0,0.0,294760,0
0xf1f7cDB20328E3F72EA48E2c1d6C424027B6484B,1285703,4,2,2,859453,426250,429726.5,213125.0,3476.5,212125.0,433203,433203
0x05aDd8246d4355b390b2be4940B88C74FB7A9C5e,9800000,2,1,1,4900000,4900000,4900000.0,4900000.0,0.0,0.0,4900000,0
0x4a183b7ED67B9E14b3f45Abfb2Cf44ed22c29E54,3724,1,1,0,3724,0,3724.0,0,0.0,0,3724,3724
0xb5BD994227ebCF1855183e7996e4A65b89506972,404334,1,1,0,404334,0,404334.0,0,0.0,0,404334,404334
0x4b4fbE602117979349E5C219E100B8AD1705e3B8,2000000,1,1,0,2000000,0,2000000.0,0,0.0,0,2000000,2000000
0x891Da4fedb025e73bE4e843328E7A0Bf6f7E5C21,95156,5,3,2,47578,47578,15859.333333333334,23789.0,4472.270738177146,1628.0,25417,0
0xef63CcA99C373690e3b730e0CA490B69188d7092,81501,1,1,0,81501,0,81501.0,0,0.0,0,81501,81501
0xD527733e330F9cEFF471085A43d1E52340952580,235882,1,1,0,235882,0,235882.0,0,0.0,0,235882,235882
0xF7E93280E56E7c9F188F7E93d7A9FfFE675F2C24,3351780,2,1,1,1675890,1675890,1675890.0,1675890.0,0.0,0.0,1675890,0
0x934BBB5E640A80ca48ddd8d30Bc4ea919D3A429a,3351780,2,1,1,1675890,1675890,1675890.0,1675890.0,0.0,0.0,1675890,0
0xF18B679E26A42b62A8225664bb51D6393049ec9A,685502,4,2,2,342751,342751,171375.5,171375.5,41783.5,41783.5,213159,0
0x6cc8dCbCA746a6E4Fdefb98E1d0DF903b107fd21,342751,2,2,0,342751,0,171375.5,0,41783.5,0,213159,342751
0xe835DBEd56E2D5fd58Cc316C4E783408b99d1793,426250,2,2,0,426250,0,213125.0,0,212125.0,0,425250,426250
0x8A6798890DA8D5443173C85f4CFd6b42aBE7852C,427900,1,1,0,427900,0,427900.0,0,0.0,0,427900,427900
0x4Ddd0E78d6A3D83ad725148b520760b2BefF7cdd,42398470,5,5,0,42398470,0,8479694.0,0,3947537.2277566683,0,15000000,42398470
0x1dC32ca94B79E3ECB11A47d50AA12D5B3A451648,423233,1,1,0,423233,0,423233.0,0,0.0,0,423233,423233
0xC6493E07d45Ebc7725d05dB5238532B16c4dB4dC,80000,1,1,0,80000,0,80000.0,0,0.0,0,80000,80000
0xC5f1DA5b7eA179125dF184E3DD08237BD9a9170B,80000,1,1,0,80000,0,80000.0,0,0.0,0,80000,80000
0xD5847248b31E42bDdCc090F6Bc702742C464E3a8,80252,1,1,0,80252,0,80252.0,0,0.0,0,80252,80252
0xe472a6D01CdC59a90dEc994163E5b80141A38c0D,95000,2,1,1,47500,47500,47500.0,47500.0,0.0,0.0,47500,0
0xaAa09d8Df83391982796402f8B0AA701EDa247a3,1545584,1,1,0,1545584,0,1545584.0,0,0.0,0,1545584,1545584
0x77B24e97A986A123983090202d7F83aFa6887d4B,4107,1,1,0,4107,0,4107.0,0,0.0,0,4107,4107
0xAaEbf21a680A251FbE047d94db8aA495d5B7049B,294400,1,1,0,294400,0,294400.0,0,0.0,0,294400,294400
0x37023E779a8e54244e881EE4591Aa207edB09871,307280,1,1,0,307280,0,307280.0,0,0.0,0,307280,307280
0x6332A47cfdD98313F4F641d1D9Cc88ac71aB3334,418000,1,1,0,418000,0,418000.0,0,0.0,0,418000,418000
0x9429Ca7d0872D631EFd9CA79Aa23F0eac91CFD5D,100000,1,1,0,100000,0,100000.0,0,0.0,0,100000,100000
0x84c7ED4AD94De42B70e73926797711f73774BE17,200000,2,1,1,100000,100000,100000.0,100000.0,0.0,0.0,100000,0
0x9427eC664642B900DA1a04cCBd8C238E3184ecc3,100000,1,1,0,100000,0,100000.0,0,0.0,0,100000,100000
0x93A344649507d378D6e80CF170d3c4b3709b944A,100000,1,1,0,100000,0,100000.0,0,0.0,0,100000,100000
0x8D4d0a91Ab6A59f62FddF5553f80117A77C302c4,61668,3,1,2,30834,30834,30834.0,15417.0,0.0,12417.0,30834,0
0x939D9e59Ddec6ff9100a0d75cB26b6355239f3e1,100000,1,1,0,100000,0,100000.0,0,0.0,0,100000,100000
0x1d2B3787CE0F2886D3C35f8120110e0ef2Dd20EF,418109,1,1,0,418109,0,418109.0,0,0.0,0,418109,1958581
0x0b34d2E4a8Cd90f0A4BCD9764e5d4608359A02E8,313564,1,1,0,313564,0,313564.0,0,0.0,0,313564,313564
0xc7Ecc98c3DeEBEC0317f75BDaFDe9A804007b48a,2626598,2,1,1,1313299,1313299,1313299.0,1313299.0,0.0,0.0,1313299,0
0xEDaE1f0d6C99ef3d50A9CAC3cF918B81B12D7A11,2626598,2,1,1,1313299,1313299,1313299.0,1313299.0,0.0,0.0,1313299,0
0x51213dD3F6774d10611c3709C44c52CBD4fDE793,23610,1,1,0,23610,0,23610.0,0,0.0,0,23610,23610
0x2e924b491D37046Eac03c97505E85a7C286210a6,1153160,4,2,2,576580,576580,288290.0,288290.0,32568.0,32568.0,320858,0
0x116847C4316C34D3fE13c706F460e31562f81c7E,251700000,2,2,0,251700000,0,125850000.0,0,125840000.0,0,251690000,251700000
0xD4423333884248D98cD8a944E9b7004413527e04,846360,2,1,1,423180,423180,423180.0,423180.0,0.0,0.0,423180,0
0xFE734C4125dC9C97CAC8bfEe5fedF2527a40EfC7,476398,2,1,1,238199,238199,238199.0,238199.0,0.0,0.0,238199,0
0xe3C29272e81209697aCAA3A812AcBeD73Dedc95c,580558,2,1,1,290279,290279,290279.0,290279.0,0.0,0.0,290279,0
0x48Bc3e7E47b2209937316389E10fD59cbe92E2B3,609450,2,1,1,304725,304725,304725.0,304725.0,0.0,0.0,304725,0
0xcC4a5A84468FCA7B4AA6AAb4EC45919E51Ac0163,846752,2,1,1,423376,423376,423376.0,423376.0,0.0,0.0,423376,0
0x7B9baCe42ff27b52e74FB632fa1FD21FA0b733F2,156821,1,1,0,156821,0,156821.0,0,0.0,0,156821,156821
0x10038ABb5f1DE7549De5e2a264a789C10c7deF66,43335,1,1,0,43335,0,43335.0,0,0.0,0,43335,43335
0xacC20BAD3CA6518B3D73DbBB77DE752D41242b32,113065,1,1,0,113065,0,113065.0,0,0.0,0,113065,113065
0x1794ae6DB8FBC0b58E612a7056f9BC75db396CB2,478678,2,1,1,239339,239339,239339.0,239339.0,0.0,0.0,239339,0
0xdFD50B68E89593D725F6B296cb39ed1CFcD4c427,825982,2,1,1,412991,412991,412991.0,412991.0,0.0,0.0,412991,0
0x09Fa38EBa245bb68354B8950FA2fe71f02863393,867704,2,1,1,433852,433852,433852.0,433852.0,0.0,0.0,433852,0
0x94d6C02972C14344A2a7045A37aA46A1B97AfB64,413142,2,1,1,206571,206571,206571.0,206571.0,0.0,0.0,206571,0
0xEe68ab7d6f7D874d2C3C3076b2199B5756a827e6,202840,1,1,0,202840,0,202840.0,0,0.0,0,202840,202840
0xe74cEA38c6ACCeF508D4c57A5280d35029b14Cd5,558598,2,1,1,279299,279299,279299.0,279299.0,0.0,0.0,279299,0
0x4C2398d5F62FDBDb61693fF1E5Fe43fde84b205C,5991200,2,1,1,2995600,2995600,2995600.0,2995600.0,0.0,0.0,2995600,0
0x3cf8A2879f11b727A381Dc934166f0015b0bAab4,2107000,1,1,0,2107000,0,2107000.0,0,0.0,0,2107000,2107000
0xE453a00eAF73BF3460Cd7F52646d9d13B1Fd6226,107931,1,0,1,0,107931,0,107931.0,0,0.0,107931,0
0x0165280C0FF720Fd3A92637788443737e4d3c66f,77304047,1,1,0,77304047,0,77304047.0,0,0.0,0,77304047,77304047
0xb967a571e0798f76566f96931Ca04Ad2Fb98aa1f,10962,1,1,0,10962,0,10962.0,0,0.0,0,10962,10962
0x9665d4caBE0a1356D357e750Afc71639307d4986,4494,1,1,0,4494,0,4494.0,0,0.0,0,4494,4494
0x4736B02DB015DCD1A57a69c889D073b100000000,5045850,2,1,1,2522926,2522924,2522926.0,2522924.0,0.0,0.0,2522926,2
0xb09DDd5d021254D90D9cbd3f773cAc504224beD8,204371,1,1,0,204371,0,204371.0,0,0.0,0,204371,204371
0x78cd31471cfAAacd11F036A9Ed4CD45B0A816127,3000,1,1,0,3000,0,3000.0,0,0.0,0,3000,3000
0xC9A667F951BAb05d3597C1dC6cD8Ce4079F378bB,6354842,2,1,1,3177421,3177421,3177421.0,3177421.0,0.0,0.0,3177421,0
0xb2F72662ed42067CCce278f8462A0215b6adcaBB,4005754,3,1,2,2002878,2002876,2002878.0,1001438.0,0.0,697062.0,2002878,2
0xBeB05B0ee229837529C3faEc22efFfca5B157499,2123,1,1,0,2123,0,2123.0,0,0.0,0,2123,2123
0xfEf9e96c8d62DD582935FD054D89377ee2Cc4FB9,34234,1,1,0,34234,0,34234.0,0,0.0,0,34234,34234
0x5e88914CE9D300e26F02E2De8760963e53d7efa3,82221,1,0,1,0,82221,0,82221.0,0,0.0,82221,0
0x94a3CFBe1429976BCCD9721F25E258cD88b17b6B,43580680,5,4,1,21790340,21790340,5447585.0,21790340.0,4092153.6524213017,0.0,21790340,0
0xEaC356cEd54Ad54B605881d5Ceb4Bb5E86231dA1,7204,1,1,0,7204,0,7204.0,0,0.0,0,7204,7204
0x27430494A8a1E83537F9068C7A1c8A7FD11d7FB9,707800,1,1,0,707800,0,707800.0,0,0.0,0,707800,707800
0x8192720Ab8a2465B6fb6aB53Df0066AC8D10De99,48010000,2,2,0,48010000,0,24005000.0,0,23995000.0,0,48000000,48010000
0xa4CB4A46A570C0A3DB29444ad16f3c33E5D89d55,100000,1,1,0,100000,0,100000.0,0,0.0,0,100000,100000
0xCb79Ffb1Cbf16B8eCA10c07ff9349D2F8AD24c81,200000,2,1,1,100000,100000,100000.0,100000.0,0.0,0.0,100000,0
0x97b8461e57eb736a95cE9C2a31452ba252946ED7,1332637,1,1,0,1332637,0,1332637.0,0,0.0,0,1332637,1332637
0x8a1543bEf11c388847590F3d071f30C6B2Fe45dF,750000,1,1,0,750000,0,750000.0,0,0.0,0,750000,750000
0xFF9F1bbA65Ebb44545db828e1539A52cCc804A00,107108,2,1,1,54510,52598,54510.0,52598.0,0.0,0.0,54510,1912
0xEF2dB2e9a44254E74Ca34ddA9761aeAe6AF63656,344644,2,1,1,172322,172322,172322.0,172322.0,0.0,0.0,172322,0
0x8ed377352E29e4a1b21De05591711590ADF8D799,732186,1,1,0,732186,0,732186.0,0,0.0,0,732186,732186
0x41Bd1BC7E4220133FD5D8A002d76B38510eE18EA,38839,1,1,0,38839,0,38839.0,0,0.0,0,38839,38839
0x436fD85267198cBDa6785e5f4859e8F116C3118b,428857,1,1,0,428857,0,428857.0,0,0.0,0,428857,428857
0x590FaBe530534cF1f9f0b83820Ab578D911ccB6B,4213,1,1,0,4213,0,4213.0,0,0.0,0,4213,4213
0x1Edbf83f04A22769971e45576c976c1ffaf0D60f,820000,1,1,0,820000,0,820000.0,0,0.0,0,820000,820000
0xECcadE9B4FCE7bB0669Aae741047062B4BAAdEa9,820000,1,1,0,820000,0,820000.0,0,0.0,0,820000,820000
0xB6827a73648B62Ba278BeC860a7C9Bb3ad3f564e,108260,1,1,0,108260,0,108260.0,0,0.0,0,108260,108260
0xbaDC0de76438f9524D42C219b390636196bfbdFc,10072268,6,3,3,5036134,5036134,1678711.3333333333,1678711.3333333333,880813.6360003869,880813.6360003869,2331007,0
0xFa967dAAFa416E2E422a64d21b8457b29aC4cdB6,3535490,1,1,0,3535490,0,3535490.0,0,0.0,0,3535490,3535490
0xef4D51DB334D5b2c8eFfE8bF8D941B4A156C5E71,844,1,1,0,844,0,844.0,0,0.0,0,844,844
0xD155f1c00262497a3106D4051F2a550f098dD3BC,30834,2,1,1,27834,3000,27834.0,3000.0,0.0,0.0,27834,24834
0x149deF34a3768f6FfcD1AE75A9B48a5f001Cc695,3000,1,1,0,3000,0,3000.0,0,0.0,0,3000,3000
0xC3d969E73C7d76EB38d91b7c8FBf78C9df7c400a,142811,1,1,0,142811,0,142811.0,0,0.0,0,142811,142811
0x6666827E8f2220dDf718193544889F3B482ED072,3919000,2,1,1,1960000,1959000,1960000.0,1959000.0,0.0,0.0,1960000,5267
0x66cb8cEd5449e67293110304C80C0e67c6E9605d,1959000,1,1,0,1959000,0,1959000.0,0,0.0,0,1959000,1959000
0xD6760bdEf7e06640988559159Bb579b92fe2Ec4C,1209551,2,2,0,1209551,0,604775.5,0,346015.5,0,950791,1209551
0x785f041A4DAe0C1E5eDcBB081F1a2BB9684eFF76,850000000,1,1,0,850000000,0,850000000.0,0,0.0,0,850000000,94350000000
0x6D3b4A436469e2D6eAd5e6645a0B68Be42313bF3,8559982,6,3,3,4279991,4279991,1426663.6666666667,1426663.6666666667,1885771.6990633362,1885771.6990633362,4093505,0
0xe8FA6B753F2A86b6E8d2420d2b72339f89bDE8D7,4279991,3,3,0,4279991,0,1426663.6666666667,0,1885771.6990633362,0,4093505,4279991
0x40533Df6A94c58a49255aeBF678f60d6273B3552,1000000,1,1,0,1000000,0,1000000.0,0,0.0,0,1000000,1000000
0xd2eF8dF4aE8319B1eF2d802C5057A339F24D6D8C,205487,1,1,0,205487,0,205487.0,0,0.0,0,205487,205487
0xD16657789f6ecc525221FB07644A808be4Ae4461,2688618,2,1,1,1344309,1344309,1344309.0,1344309.0,0.0,0.0,1344309,0
0x84EbA68F1F44B2afF6CEbaD6C416591F3052A4c2,1151644,3,1,2,575822,575822,575822.0,287911.0,0.0,37911.0,575822,0
0x10Dce18d6B5C779bc8DE620F8D0a561dfc3a51F0,12000000,1,1,0,12000000,0,12000000.0,0,0.0,0,12000000,12000000
0x597f6182870A95fe056e658Aa3192338380F33AF,500000,1,1,0,500000,0,500000.0,0,0.0,0,500000,500000
0x5754284f345afc66a98fbB0a0Afe71e0F007B949,500000000,1,0,1,0,500000000,0,500000000.0,0,0.0,500000000,66178901500
0x7e7513df5BaEE3Aa82F703FbF9c1f2f2F9b06790,500000,1,1,0,500000,0,500000.0,0,0.0,0,500000,500000
0x1b4A01290872C2154353349323014e50Ca98E7A2,7366800,5,3,2,3683400,3683400,1227800.0,1841700.0,392127.1562473921,84900.0,1926600,0
0xAFb60A1cb7733a41d1E88319b4b78B47dd5C32C5,5854628,6,3,3,2927314,2927314,975771.3333333334,975771.3333333334,340951.44156544574,340951.44156544574,1283823,0
0x43931eE1d5FBA84Ca6670383b523A80b19D3c0A4,3568642,3,2,1,1784321,1784321,892160.5,1784321.0,391662.5,0.0,1784321,0
0xC7cFa04a877Ee036d6faf408621Aa97326f4Fb63,439400,2,2,0,439400,0,219700.0,0,113900.0,0,333600,439400
0x68C749b2D6413289820e9e5380aa43D7DBaeE91b,194400,1,1,0,194400,0,194400.0,0,0.0,0,194400,194400
0x3A29BCF9f5Db13A538f90EA6B9bBD01B37b917f3,23723,1,1,0,23723,0,23723.0,0,0.0,0,23723,23723
0x9945453655EA65e0211942906D828D4332B582A4,2069168,1,1,0,2069168,0,2069168.0,0,0.0,0,2069168,2069168
0x009a94c2804fe055E5Ad7411eEf949540AA99EA5,500000,1,1,0,500000,0,500000.0,0,0.0,0,500000,500000
0x24902AA0cf0000a08c0EA0b003B0c0bF600000E0,2863815,2,1,1,1431908,1431907,1431908.0,1431907.0,0.0,0.0,1431908,1
0xAfafa3A1995cfceB3D641C75474616843A7d97b8,1283872,2,1,1,641936,641936,641936.0,641936.0,0.0,0.0,641936,0
0xcBD3C004701a0C94c1d8A480D51aa4969D081F16,2473322,2,1,1,1236661,1236661,1236661.0,1236661.0,0.0,0.0,1236661,0
0x8b17FaF9b1F3EE5af584c480d2E136434f94A840,470000,1,1,0,470000,0,470000.0,0,0.0,0,470000,470000
0xe57106b340DaA21AB93F73fA1d91E8935A43b3fA,2185645,2,2,0,2185645,0,1092822.5,0,1049321.5,0,2142144,2185645
0x89dC108Cc17ae2b5CA8c2de8D6510d4011e27F52,287000,2,1,1,143500,143500,143500.0,143500.0,0.0,0.0,143500,0
0xE54679F49b0a1CFC4b6451938D0B5d35E67E4d76,500000,2,1,1,250000,250000,250000.0,250000.0,0.0,0.0,250000,0
0x031C98ebe2F25544e8Ddf2684f7d70aE4AAfd8C1,2050000,1,1,0,2050000,0,2050000.0,0,0.0,0,2050000,2050000
0x2F472b7672302796326C4fA85a317c591918c14A,651644,2,1,1,325822,325822,325822.0,325822.0,0.0,0.0,325822,0
0x9fefd98F88c4867b6a89b8Fe5Dd9c4cFCAf1b482,1157882,1,1,0,1157882,0,1157882.0,0,0.0,0,1157882,1157882
0x5FBEaf978A7F2e0389bD6162e6d695A9cbB5896f,12043585,1,1,0,12043585,0,12043585.0,0,0.0,0,12043585,12043585
